お金	おかね
お父さん	おとうさん
お母さん	おかあさん
こんな	こんな
さあ	さあ
さん	さん
そう	そう
そんな	そんな
どうも	どうも
もう	もう
もっと	もっと
ゆっくり	ゆっくり
アパート	あぱーと
エレベーター	えれべーたー
カップ	かっぷ
カメラ	かめら
カレー	かれー
カレンダー	かれんだー
キロ	きろ
ギター	ぎたー
クラス	くらす
グラム	ぐらむ
コート	こーと
コップ	こっぷ
シャツ	しゃつ
シャワー	しゃわー
スカート	すかーと
ストーブ	すとーぶ
スプーン	すぷーん
スポーツ	すぽーつ
ズボン	ずぼん
セーター	せーたー
ゼロ	ぜろ
タクシー	たくしー
テーブル	てーぶる
テープ	てーぷ
テスト	てすと
テレビ	てれび
デパート	でぱーと
トイレ	といれ
ドア	どあ
ナイフ	ないふ
ニュース	にゅーす
ネクタイ	ねくたい
ノート	のーと
ハンカチ	はんかち
バス	ばす
バター	ばたー
パーティー	ぱーてぃー
パン	ぱん
フィルム	ふぃるむ
フォーク	ふぉーく
プール	ぷーる
ベッド	べっど
ペン	ぺん
ホテル	ほてる
ボールペン	ぼーるぺん
ポケット	ぽけっと
マッチ	まっち
メートル	めーとる
ラジオ	らじお
レコード	れこーど
レストラン	れすとらん
安い	やすい
一	いち
一つ	ひとつ
飲む	のむ
右	みぎ
駅	えき
円	えん
下手	へた
どうぞ	どうぞ
花	はな
会社	かいしゃ
外国	がいこく
学校	がっこう
学生	がくせい
休み	やすみ
休む	やすむ
空	そら
見せる	みせる
見る	みる
古い	ふるい
五	ご
五つ	いつつ
午後	ごご
午前	ごぜん
後ろ	うしろ
語	ご
口	くち
高い	たかい
今	いま
今月	こんげつ
今週	こんしゅう
左	ひだり
三つ	みっつ
山	やま
四つ	よっつ
時	とき
時間	じかん
耳	みみ
七	なな
車	くるま
手	て
週間	しゅうかん
出す	だす
出る	でる
出口	でぐち
出来る	できる
書く	かく
女	おんな
女の子	おんなのこ
小さい	ちいさい
少し	すこし
上	うえ
上げる	あげる
上手	じょうず
食べる	たべる
新聞	しんぶん
人	じん
水	みず
生まれる	うまれる
西	にし
先	さき
先月	せんげつ
先週	せんしゅう
先生	せんせい
千	せん
前	まえ
足	あし
大学	だいがく
大人	おとな
男	おとこ
男の子	おとこのこ
長い	ながい
天気	てんき
電気	でんき
電車	でんしゃ
電話	でんわ
東	ひがし
道	みち
読む	よむ
南	みなみ
二	に
二つ	ふたつ
日本語	にほんご
入る	はいる
入れる	いれる
買う	かう
白	しろ
白い	しろい
半	はん
半分	はんぶん
百	ひゃく
父	ちち
分	ふん
母	はは
北	きた
本	ほん
毎週	まいしゅう
毎日	まいにち
名前	なまえ
木	き
来る	くる
来月	らいげつ
来週	らいしゅう
来年	らいねん
話す	はなす
何	なに
何	なん
魚	さかな
九	きゅう
行く	いく
今日	きょう
今年	ことし
三	さん
四	よん
十	じゅう
人	ひと
店	みせ
八	はち
毎年	まいとし
万	まん
六	ろく
言う	いう
大きい	おおきい
聞く	きく
国	くに
立つ	たつ
出かける	でかける
話	はなし
分かる	わかる
母さん	かあさん
父さん	とうさん
時	じ
日	にち
年	ねん
いる	いる
人	にん
お茶	おちゃ
悪い	わるい
暗い	くらい
意味	いみ
医者	いしゃ
引く	ひく
映画	えいが
英語	えいご
遠い	とおい
音楽	おんがく
夏	なつ
夏休み	なつやすみ
家族	かぞく
火曜日	かようび
会う	あう
回	かい
海	うみ
開ける	あける
楽しい	たのしい
寒い	さむい
漢字	かんじ
帰る	かえる
起きる	おきる
牛肉	ぎゅうにく
去年	きょねん
強い	つよい
教える	おしえる
教室	きょうしつ
近い	ちかい
近く	ちかく
金曜日	きんようび
銀行	ぎんこう
兄さん	にいさん
兄弟	きょうだい
軽い	かるい
月	つき
月曜日	げつようび
建物	たてもの
犬	いぬ
元気	げんき
ご飯	ごはん
好き	すき
広い	ひろい
考える	かんがえる
黒	くろ
黒い	くろい
有る	ある
作文	さくぶん
仕事	しごと
使う	つかう
始まる	はじまる
姉	あね
姉さん	ねえさん
止まる	とまる
死ぬ	しぬ
私	わたし
持つ	もつ
時計	とけい
自転車	じてんしゃ
自動車	じどうしゃ
自分	じぶん
質問	しつもん
写真	しゃしん
借りる	かりる
弱い	よわい
手紙	てがみ
秋	あき
習う	ならう
住む	すむ
重い	おもい
春	はる
始め	はじめ
暑い	あつい
少ない	すくない
乗る	のる
色	いろ
食べ物	たべもの
食堂	しょくどう
新しい	あたらしい
図書館	としょかん
水曜日	すいようび
青	あお
青い	あおい
赤い	あかい
切る	きる
切手	きって
洗う	あらう
走る	はしる
早い	はやい
多い	おおい
多分	たぶん
太い	ふとい
待つ	まつ
貸す	かす
台所	だいどころ
大きな	おおきな
大好き	だいすき
大使館	たいしかん
大切	たいせつ
短い	みじかい
知る	しる
地図	ちず
茶色	ちゃいろ
着く	つく
着る	きる
昼	ひる
朝	あさ
鳥	とり
低い	ひくい
度	ど
土曜日	どようび
冬	ふゆ
答える	こたえる
働く	はたらく
動物	どうぶつ
同じ	おなじ
肉	にく
日曜日	にちようび
売る	うる
病院	びょういん
病気	びょうき
風	かぜ
服	ふく
物	もの
勉強	べんきょう
歩く	あるく
妹	いもうと
毎朝	まいあさ
明るい	あかるい
木曜日	もくようび
問題	もんだい
夜	よる
野菜	やさい
薬	くすり
有名	ゆうめい
夕べ	ゆうべ
夕方	ゆうがた
洋服	ようふく
旅行	りょこう
料理	りょうり
今朝	けさ
上着	うわぎ
頭	あたま
明日	あした
門	もん
開く	あく
色々	いろいろ
歌う	うたう
思う	おもう
終わる	おわる
買い物	かいもの
作る	つくる
飲み物	のみもの
町	まち
赤	あか
屋	や
小さな	ちいさな
泳ぐ	およぐ
横	よこ
黄色い	きいろい
家庭	かてい
荷物	にもつ
絵	え
階	かい
勤める	つとめる
君	きみ
言葉	ことば
戸	と
公園	こうえん
向こう	むこう
細い	ほそい
皿	さら
歯	は
取る	とる
宿題	しゅくだい
消える	きえる
消す	けす
登る	のぼる
晴れ	はれ
晴れる	はれる
雪	ゆき
全部	ぜんぶ
速い	はやい
地下鉄	ちかてつ
飛ぶ	とぶ
庭	にわ
豚肉	ぶたにく
番号	ばんごう
美味しい	おいしい
鼻	はな
部屋	へや
文章	ぶんしょう
返す	かえす
方	かた
本当	ほんとう
無い	ない
無くす	なくす
鳴く	なく
面白い	おもしろい
遊ぶ	あそぶ
葉書	はがき
留学生	りゅうがくせい
緑	みどり
練習	れんしゅう
一昨日	おととい
一昨年	いっさくねん
黄色	きいろ
昨日	きのう
真っ直ぐ	まっすぐ
側	がわ
弟	おとうと
両親	りょうしん
丸い	まるい
本当に	ほんとうに
番	ばん
お腹	おなか
違う	ちがう
一緒	いっしょ
汚い	きたない
奥さん	おくさん
押す	おす
果物	くだもの
過ぎ	すぎ
皆さん	みなさん
階段	かいだん
覚える	おぼえる
甘い	あまい
危ない	あぶない
机	つくえ
喫茶店	きっさてん
吸う	すう
牛乳	ぎゅうにゅう
狭い	せまい
靴	くつ
靴下	くつした
警官	けいかん
結構	けっこう
結婚	けっこん
個	こ
呼ぶ	よぶ
厚い	あつい
紅茶	こうちゃ
降る	ふる
今晩	こんばん
困る	こまる
座る	すわる
財布	さいふ
咲く	さく
冊	さつ
雑誌	ざっし
子供	こども
辞書	じしょ
若い	わかい
授業	じゅぎょう
初めて	はじめて
寝る	ねる
辛い	つらい
吹く	ふく
生徒	せいと
静か	しずか
切符	きっぷ
洗濯	せんたく
掃除	そうじ
窓	まど
大変	たいへん
置く	おく
遅い	おそい
痛い	いたい
閉まる	しまる
渡す	わたす
渡る	わたる
難しい	むずかしい
猫	ねこ
熱い	あつい
薄い	うすい
晩	ばん
彼	かれ
彼ら	かれら
彼女	かのじょ
疲れる	つかれる
飛行機	ひこうき
必要	ひつよう
封筒	ふうとう
並ぶ	ならぶ
並べる	ならべる
閉める	しめる
便利	べんり
帽子	ぼうし
忘れる	わすれる
忙しい	いそがしい
磨く	みがく
枚	まい
毎晩	まいばん
友達	ともだち
要る	いる
欲しい	ほしい
浴びる	あびる
頼む	たのむ
卵	たまご
涼しい	すずしい
冷たい	つめたい
冷蔵庫	れいぞうこ
塩	しお
可愛い	かわいい
居る	いる
頃	ころ
頃	ごろ
否	いいえ
匹	ひき
余り	あまり
暖かい	あたたかい
降りる	おりる
交差点	こうさてん
段々	だんだん
達	たち
椅子	いす
鉛筆	えんぴつ
掛かる	かかる
鞄	かばん
幾ら	いくら
貴方	あなた
鍵	かぎ
玄関	げんかん
砂糖	さとう
撮る	とる
傘	かさ
大丈夫	だいじょうぶ
沢山	たくさん
脱ぐ	ぬぐ
誰	だれ
弾く	ひく
丁度	ちょうど
貼る	はる
締める	しめる
賑やか	にぎやか
箸	はし
風呂	ふろ
弁当	べんとう
僕	ぼく
殆ど	ほとんど
本棚	ほんだな
立派	りっぱ
隣	となり
何故	なぜ
暇	ひま
眼鏡	めがね
丈夫	じょうぶ
風邪	かぜ
嫌	いや
煙草	たばこ
良い	よい
叔父	おじ
叔母	おば
嫌がる	いやがる
彼処	あそこ
彼の	あの
彼	あれ
此方	こちら
此方	こっち
然して	そして
其方	そちら
其方	そっち
其の	その
其れ	それ
詰らない	つまらない
迚も	とても
如何	どう
何方	どっち
何れ	どれ
遣る	やる
為る	する
一寸	ちょっと
何時も	いつも
何方	どちら
幾つ	いくつ
呉れる	くれる
此処	ここ
在る	ある
事	こと
成る	なる
石鹸	せっけん
其れでは	それでは
如何して	どうして
煩い	うるさい
彼方	あちら
彼方	あっち
不味い	まずい
又	また
未だ	まだ
勿論	もちろん
何処	どこ
如何	いかが
此の	この
奇麗	きれい
醤油	しょうゆ
様	よう
点ける	つける
何の	どの
もう一度	もういちど
其処	そこ
此れ	これ
いらっしゃる	いらっしゃる
うん	うん
さっき	さっき
すっかり	すっかり
ちゃん	ちゃん
はっきり	はっきり
やっと	やっと
そろそろ	そろそろ
上がる	あがる
日本	にっぽん
お子さん	おこさん
アルバイト	あるばいと
オートバイ	おーとばい
カーテン	かーてん
ガソリン	がそりん
コンサート	こんさーと
サンダル	さんだる
サンドイッチ	さんどいっち
ジャム	じゃむ
ステレオ	すてれお
タイプ	たいぷ
テキスト	てきすと
ビル	びる
プレゼント	ぷれぜんと
ベル	べる
ママ	まま
安心	あんしん
以下	いか
以外	いがい
以上	いじょう
意見	いけん
医学	いがく
員	いん
運ぶ	はこぶ
運転	うんてん
運動	うんどう
屋上	おくじょう
下げる	さげる
下さる	くださる
下着	したぎ
火	ひ
火事	かじ
花見	はなみ
会	かい
会場	かいじょう
会話	かいわ
開く	ひらく
楽しみ	たのしみ
楽しむ	たのしむ
間に合う	まにあう
気	き
気分	きぶん
起こす	おこす
急	きゅう
急ぐ	いそぐ
急行	きゅうこう
教会	きょうかい
金持ち	かねもち
空気	くうき
計画	けいかく
建てる	たてる
研究	けんきゅう
見える	みえる
見物	けんぶつ
工業	こうぎょう
校長	こうちょう
高校	こうこう
高校生	こうこうせい
合う	あう
今度	こんど
今夜	こんや
始める	はじめる
子	こ
思い出す	おもいだす
上手い	うまい
止む	やむ
止める	とめる
止める	やめる
試験	しけん
試合	しあい
字	じ
時代	じだい
社会	しゃかい
社長	しゃちょう
集める	あつめる
出発	しゅっぱつ
小学校	しょうがっこう
小説	しょうせつ
小鳥	ことり
少年	しょうねん
場合	ばあい
食事	しょくじ
親	おや
親切	しんせつ
人口	じんこう
水道	すいどう
世界	せかい
世話	せわ
正しい	ただしい
正月	しょうがつ
生きる	いきる
西洋	せいよう
赤ちゃん	あかちゃん
説明	せつめい
送る	おくる
足す	たす
足りる	たりる
村	むら
太る	ふとる
大学生	だいがくせい
大事	だいじ
大体	だいたい
知らせる	しらせる
地理	ちり
着物	きもの
中学校	ちゅうがっこう
昼休み	ひるやすみ
注意	ちゅうい
通う	かよう
通り	とおり
通る	とおる
店員	てんいん
都合	つごう
答え	こたえ
動く	うごく
特に	とくに
特別	とくべつ
入院	にゅういん
入学	にゅうがく
発音	はつおん
品物	しなもの
不便	ふべん
文学	ぶんがく
別	べつ
別に	べつに
用	よう
用意	ようい
用事	ようじ
立てる	たてる
旅館	りょかん
工場	こうじょう
行く	ゆく
昼間	ひるま
夕飯	ゆうはん
空く	あく
写す	うつす
売り場	うりば
行う	おこなう
下りる	おりる
代わり	かわり
聞こえる	きこえる
気持ち	きもち
仕方	しかた
台風	たいふう
乗り物	のりもの
引き出し	ひきだし
引き出す	ひきだす
回る	まわる
真ん中	まんなか
見つかる	みつかる
見つける	みつける
別れる	わかれる
代	だい
安全	あんぜん
以内	いない
育てる	そだてる
雲	くも
下宿	げしゅく
家内	かない
科学	かがく
海岸	かいがん
学部	がくぶ
客	きゃく
泣く	なく
教育	きょういく
近所	きんじょ
苦い	にがい
空港	くうこう
君	くん
決して	けっして
決める	きめる
血	ち
湖	みずうみ
お礼	おれい
交通	こうつう
光る	ひかる
港	みなと
細かい	こまかい
参る	まいる
残る	のこる
市	し
指	ゆび
糸	いと
歯医者	はいしゃ
寺	てら
自由	じゆう
手伝う	てつだう
受ける	うける
拾う	ひろう
住所	じゅうしょ
勝つ	かつ
焼く	やく
焼ける	やける
場所	ばしょ
植える	うえる
心配	しんぱい
森	もり
深い	ふかい
申し上げる	もうしあげる
申す	もうす
真面目	まじめ
神社	じんじゃ
進む	すすむ
人形	にんぎょう
水泳	すいえい
数学	すうがく
星	ほし
生活	せいかつ
製	せい
昔	むかし
石	いし
線	せん
全然	ぜんぜん
相談	そうだん
草	くさ
息子	むすこ
打つ	うつ
虫	むし
調べる	しらべる
点	てん
伝える	つたえる
島	しま
投げる	なげる
湯	ゆ
道具	どうぐ
日記	にっき
倍	ばい
反対	はんたい
番組	ばんぐみ
悲しい	かなしい
飛行場	ひこうじょう
美しい	うつくしい
美術館	びじゅつかん
負ける	まける
部長	ぶちょう
文化	ぶんか
返事	へんじ
放送	ほうそう
貿易	ぼうえき
無くなる	なくなる
無理	むり
鳴る	なる
毛	け
役に立つ	やくにたつ
遊び	あそび
予習	よしゅう
予定	よてい
様	さま
葉	は
落ちる	おちる
理由	りゆう
留守	るす
両方	りょうほう
例えば	たとえば
礼	れい
選ぶ	えらぶ
決まる	きまる
具合	ぐあい
全て	すべて
確か	たしか
直す	なおす
直る	なおる
祭り	まつり
お祭り	おまつり
向かう	むかう
島	とう
案内	あんない
移る	うつる
引っ越す	ひっこす
汚れる	よごれる
億	おく
課長	かちょう
過ぎる	すぎる
会議	かいぎ
掛ける	かける
割れる	われる
乾く	かわく
慣れる	なれる
簡単	かんたん
間違える	まちがえる
関係	かんけい
危険	きけん
喜ぶ	よろこぶ
寄る	よる
機会	きかい
機械	きかい
祈る	いのる
季節	きせつ
規則	きそく
技術	ぎじゅつ
久しぶり	ひさしぶり
競争	きょうそう
隅	すみ
景色	けしき
経験	けいけん
経済	けいざい
警察	けいさつ
迎える	むかえる
固い	かたい
原因	げんいん
講堂	こうどう
郊外	こうがい
国際	こくさい
差し上げる	さしあげる
砂	すな
最近	さいきん
最後	さいご
最初	さいしょ
妻	つま
済む	すむ
産業	さんぎょう
残念	ざんねん
市民	しみん
指輪	ゆびわ
支度	したく
枝	えだ
事故	じこ
事務所	じむしょ
似る	にる
失敗	しっぱい
失礼	しつれい
捨てる	すてる
取り替える	とりかえる
手袋	てぶくろ
習慣	しゅうかん
柔道	じゅうどう
準備	じゅんび
女性	じょせい
将来	しょうらい
承知	しょうち
招待	しょうたい
笑う	わらう
紹介	しょうかい
畳	たたみ
触る	さわる
政治	せいじ
席	せき
赤ん坊	あかんぼう
折る	おる
折れる	おれる
専門	せんもん
戦争	せんそう
祖父	そふ
祖母	そぼ
続く	つづく
続ける	つづける
卒業	そつぎょう
男性	だんせい
地震	じしん
恥ずかしい	はずかしい
珍しい	めずらしい
程	ほど
適当	てきとう
電灯	でんとう
電報	でんぽう
塗る	ぬる
土産	みやげ
怒る	おこる
倒れる	たおれる
盗む	ぬすむ
逃げる	にげる
届ける	とどける
曇る	くもる
熱	ねつ
背中	せなか
泊まる	とまる
髪	かみ
比べる	くらべる
必ず	かならず
付く	つく
夫	おっと
布団	ふとん
普通	ふつう
復習	ふくしゅう
複雑	ふくざつ
払う	はらう
仏教	ぶっきょう
文法	ぶんぽう
壁	かべ
変	へん
変える	かえる
変わる	かわる
片付ける	かたづける
暮れる	くれる
法律	ほうりつ
訪ねる	たずねる
亡くなる	なくなる
眠い	ねむい
眠る	ねむる
夢	ゆめ
娘	むすめ
戻る	もどる
約束	やくそく
踊る	おどる
輸出	ゆしゅつ
優しい	やさしい
予約	よやく
踊り	おどり
利用	りよう
裏	うら
冷える	ひえる
歴史	れきし
連れる	つれる
連絡	れんらく
腕	うで
途中	とちゅう
包む	つつむ
頂く	いただく
受付	うけつけ
贈り物	おくりもの
遅れる	おくれる
格好	かっこう
込む	こむ
怖い	こわい
ご存じ	ごぞんじ
探す	さがす
捕まえる	つかまえる
泥棒	どろぼう
治る	なおる
値段	ねだん
乗り換える	のりかえる
増える	ふえる
舟	ふね
周り	まわり
見舞い	みまい
柔らかい	やわらかい
沸く	わく
割合	わりあい
お祝い	おいわい
お嬢さん	おじょうさん
挨拶	あいさつ
為	ため
一生懸命	いっしょうけんめい
嘘	うそ
壊す	こわす
壊れる	こわれる
滑る	すべる
噛む	かむ
頑張る	がんばる
嬉しい	うれしい
汽車	きしゃ
宜しい	よろしい
興味	きょうみ
驚く	おどろく
喧嘩	けんか
絹	きぬ
厳しい	きびしい
故障	こしょう
講義	こうぎ
謝る	あやまる
邪魔	じゃま
趣味	しゅみ
飾る	かざる
尋ねる	たずねる
随分	ずいぶん
是非	ぜひ
盛ん	さかん
先輩	せんぱい
素晴らしい	すばらしい
騒ぐ	さわぐ
駄目	だめ
棚	たな
暖房	だんぼう
致す	いたす
注射	ちゅうしゃ
丁寧	ていねい
釣る	つる
田舎	いなか
踏む	ふむ
濡れる	ぬれる
翻訳	ほんやく
漫画	まんが
味噌	みそ
揺れる	ゆれる
冷房	れいぼう
寂しい	さびしい
包む	くるむ
ご馳走	ごちそう
辞典	じてん
誉める	ほめる
我々	われわれ
訳	やく
屹度	きっと
斯う	こう
此れから	これから
其れ程	それほど
些とも	ちっとも
矢っ張り	やっぱり
矢張り	やはり
可笑しい	おかしい
苛める	いじめる
玩具	おもちゃ
吃驚	びっくり
御	ご
暫く	しばらく
仕舞う	しまう
塵	ごみ
凄い	すごい
積もり	つもり
打つ	ぶつ
到頭	とうとう
筈	はず
又は	または
貰う	もらう
訳	わけ
儘	まま
確り	しっかり
中々	なかなか
喉	のど
酷い	ひどい
痩せる	やせる
然うして	そうして
もう直ぐ	もうすぐ
うっかり	うっかり
お前	おまえ
がっかり	がっかり
きちんと	きちんと
きつい	きつい
こっそり	こっそり
こんなに	こんなに
さっさと	さっさと
さっぱり	さっぱり
ざっと	ざっと
しつこい	しつこい
じっと	じっと
ずっと	ずっと
そっくり	そっくり
そっと	そっと
たっぷり	たっぷり
だらけ	だらけ
ちゃんと	ちゃんと
どうせ	どうせ
どっと	どっと
どんどん	どんどん
どんなに	どんなに
のんびり	のんびり
ぴったり	ぴったり
ぼんやり	ぼんやり
まあ	まあ
オーバー	おーばー
下る	くだる
何とか	なんとか
何とも	なんとも
火山	かざん
外す	はずす
外れる	はずれる
外出	がいしゅつ
学ぶ	まなぶ
気に入る	きにいる
金	きん
見下ろす	みおろす
見上げる	みあげる
今後	こんご
左右	さゆう
週	しゅう
女子	じょし
上	じょう
人間	にんげん
人気	にんき
人生	じんせい
生える	はえる
生じる	しょうじる
先日	せんじつ
大いに	おおいに
大した	たいした
大して	たいして
大半	たいはん
男子	だんし
中学	ちゅうがく
長	ちょう
電子	でんし
読書	どくしょ
年間	ねんかん
年中	ねんじゅう
半ば	なかば
分ける	わける
本人	ほんにん
本来	ほんらい
名人	めいじん
友	とも
友人	ゆうじん
来	らい
一生	いっしょう
行き	いき
年月	としつき
食う	くう
見つめる	みつめる
分かれる	わかれる
生き生き	いきいき
生まれ	うまれ
何で	なんで
中	ちゅう
どうか	どうか
学	がく
あんなに	あんなに
せっせと	せっせと
そんなに	そんなに
社	しゃ
みたい	みたい
間	かん
大	だい
生	せい
後	ご
名	めい
以前	いぜん
以来	いらい
意外	いがい
意思	いし
一体	いったい
一方	いっぽう
引用	いんよう
運	うん
下がる	さがる
家事	かじ
歌手	かしゅ
花火	はなび
画家	がか
会員	かいいん
会計	かいけい
海外	かいがい
開始	かいし
学者	がくしゃ
学習	がくしゅう
学問	がくもん
楽	らく
起こる	おこる
牛	うし
去る	さる
強力	きょうりょく
見事	みごと
見送る	みおくる
言わば	いわば
後者	こうしゃ
公正	こうせい
広場	ひろば
行動	こうどう
高度	こうど
国家	こっか
国会	こっかい
作家	さっか
作業	さぎょう
作品	さくひん
使用	しよう
思わず	おもわず
持ち上げる	もちあげる
自ら	みずから
自動	じどう
室	しつ
質	しつ
借金	しゃっきん
手間	てま
手入れ	ていれ
重大	じゅうだい
出会い	であい
出来事	できごと
書店	しょてん
小屋	こや
上京	じょうきょう
食品	しょくひん
食料	しょくりょう
真っ赤	まっか
親しい	したしい
親友	しんゆう
人工	じんこう
図	ず
世の中	よのなか
世間	せけん
正午	しょうご
生地	きじ
青年	せいねん
切れる	きれる
先ず	まず
前者	ぜんしゃ
足る	たる
多少	たしょう
体重	たいじゅう
貸し	かし
代金	だいきん
代理	だいり
台	だい
大家	おおや
大会	たいかい
大使	たいし
題	だい
知事	ちじ
地	ち
地下	ちか
地方	ちほう
中止	ちゅうし
中心	ちゅうしん
注文	ちゅうもん
注目	ちゅうもく
度	たび
土地	とち
動かす	うごかす
動作	どうさ
同一	どういつ
特急	とっきゅう
入場	にゅうじょう
年代	ねんだい
売れる	うれる
発	はつ
発見	はっけん
発行	はっこう
病	やまい
不安	ふあん
不運	ふうん
不正	ふせい
不足	ふそく
父親	ちちおや
分野	ぶんや
文	ぶん
文字	もじ
別れ	わかれ
歩道	ほどう
母親	ははおや
味わう	あじわう
味方	みかた
目立つ	めだつ
野	の
有料	ゆうりょう
用いる	もちいる
用心	ようじん
立ち止まる	たちどまる
立ち上がる	たちあがる
立場	たちば
旅	たび
料金	りょうきん
力	りょく
話題	わだい
一家	いっか
姉妹	しまい
主人	しゅじん
少女	しょうじょ
注ぐ	そそぐ
転ぶ	ころぶ
空く	すく
足元	あしもと
言う	ゆう
思い出	おもいで
少々	しょうしょう
銀	ぎん
少なくとも	すくなくとも
建つ	たつ
出会う	であう
計る	はかる
昼食	ちゅうしょく
広がる	ひろがる
広げる	ひろげる
お昼	おひる
不	ふ
者	しゃ
元	もと
安定	あんてい
委員	いいん
易い	やすい
育つ	そだつ
一流	いちりゅう
引退	いんたい
羽	はね
営業	えいぎょう
横切る	よこぎる
横断	おうだん
王子	おうじ
王様	おうさま
屋根	やね
温度	おんど
化学	かがく
加える	くわえる
加わる	くわわる
家具	かぐ
火曜	かよう
会合	かいごう
会費	かいひ
回す	まわす
回転	かいてん
絵画	かいが
外交	がいこう
確かめる	たしかめる
確実	かくじつ
学期	がっき
額	がく
活気	かっき
活動	かつどう
活用	かつよう
感じ	かんじ
感じる	かんじる
感情	かんじょう
感心	かんしん
感動	かんどう
観客	かんきゃく
観光	かんこう
丸	まる
岸	きし
岩	いわ
期間	きかん
期待	きたい
気温	きおん
記事	きじ
記者	きしゃ
記入	きにゅう
記録	きろく
逆	ぎゃく
逆らう	さからう
休息	きゅうそく
急速	きゅうそく
求める	もとめる
旧	きゅう
強調	きょうちょう
教科書	きょうかしょ
禁止	きんし
金額	きんがく
金庫	きんこ
金曜	きんよう
区別	くべつ
苦しい	くるしい
苦しむ	くるしむ
苦手	にがて
計算	けいさん
欠ける	かける
欠点	けってん
決心	けっしん
決定	けってい
月曜	げつよう
県	けん
言語	げんご
語る	かたる
公平	こうへい
向く	むく
向け	むけ
向ける	むける
幸い	さいわい
幸福	こうふく
高速	こうそく
号	ごう
合わせる	あわせる
合計	ごうけい
合図	あいず
国王	こくおう
黒板	こくばん
今回	こんかい
根	ね
混ぜる	まぜる
才能	さいのう
作物	さくもつ
参加	さんか
残り	のこり
思想	しそう
指す	さす
指導	しどう
試し	ためし
試す	ためす
事実	じじつ
事情	じじょう
時期	じき
自身	じしん
自然	しぜん
式	しき
実	み
実は	じつは
実験	じっけん
実行	じっこう
取り出す	とりだす
取り消す	とりけす
取り上げる	とりあげる
取れる	とれる
守る	まもる
手術	しゅじゅつ
手伝い	てつだい
首相	しゅしょう
首都	しゅと
受け取る	うけとる
州	しゅう
終える	おえる
集会	しゅうかい
集中	しゅうちゅう
宿	やど
出身	しゅっしん
書物	しょもつ
書類	しょるい
助かる	たすかる
助ける	たすける
助手	じょしゅ
女王	じょおう
勝負	しょうぶ
商売	しょうばい
商品	しょうひん
小麦	こむぎ
消費	しょうひ
場面	ばめん
常に	つねに
植物	しょくぶつ
食物	しょくもつ
新た	あらた
身	み
身長	しんちょう
身分	みぶん
進める	すすめる
進学	しんがく
進歩	しんぽ
人物	じんぶつ
人類	じんるい
数える	かぞえる
数字	すうじ
正確	せいかく
正式	せいしき
正直	しょうじき
生き物	いきもの
生物	せいぶつ
生命	せいめい
実に	じつに
石炭	せきたん
石油	せきゆ
選手	せんしゅ
前進	ぜんしん
全	ぜん
全く	まったく
全員	ぜんいん
全身	ぜんしん
全体	ぜんたい
全力	ぜんりょく
組み立てる	くみたてる
組む	くむ
組合	くみあい
相手	あいて
相当	そうとう
息	いき
速度	そくど
太陽	たいよう
身体	しんたい
体温	たいおん
対	たい
代表	だいひょう
単なる	たんなる
単に	たんに
単語	たんご
断る	ことわる
知能	ちのう
地球	ちきゅう
地区	ちく
地点	ちてん
地面	じめん
中央	ちゅうおう
調子	ちょうし
長期	ちょうき
長所	ちょうしょ
直ちに	ただちに
追う	おう
通じる	つうじる
通す	とおす
通学	つうがく
通知	つうち
低下	ていか
的	てき
鉄	てつ
鉄道	てつどう
伝わる	つたわる
電池	でんち
登山	とざん
都会	とかい
都市	とし
土曜	どよう
当たり前	あたりまえ
当たる	あたる
当てる	あてる
当てはまる	あてはまる
当時	とうじ
等しい	ひとしい
同様	どうよう
道路	どうろ
特定	とくてい
日光	にっこう
日曜	にちよう
能力	のうりょく
農家	のうか
農業	のうぎょう
波	なみ
馬	うま
配る	くばる
発表	はっぴょう
発明	はつめい
犯人	はんにん
番目	ばんめ
悲しむ	かなしむ
皮肉	ひにく
費	ひ
費用	ひよう
飛ばす	とばす
飛び出す	とびだす
美人	びじん
氷	こおり
表	ひょう
表情	ひょうじょう
表面	ひょうめん
秒	びょう
不幸	ふこう
不自由	ふじゆう
不満	ふまん
部	ぶ
部分	ぶぶん
物語	ものがたり
物事	ものごと
物質	ぶっしつ
物理	ぶつり
分類	ぶんるい
文明	ぶんめい
平ら	たいら
平気	へいき
平等	びょうどう
平和	へいわ
辺り	あたり
放す	はなす
方向	ほうこう
望み	のぞみ
望む	のぞむ
防ぐ	ふせぐ
本物	ほんもの
満足	まんぞく
無し	なし
無事	ぶじ
無料	むりょう
命	いのち
命じる	めいじる
明ける	あける
明らか	あきらか
明確	めいかく
迷う	まよう
鳴らす	ならす
木曜	もくよう
目指す	めざす
目的	もくてき
夜明け	よあけ
役	やく
友情	ゆうじょう
有能	ゆうのう
昨夜	さくや
予期	よき
予算	よさん
様子	ようす
陽気	ようき
理想	りそう
流す	ながす
流れ	ながれ
流れる	ながれる
流行る	はやる
留学	りゅうがく
量	りょう
例外	れいがい
列	れつ
列車	れっしゃ
話し合う	はなしあう
商人	しょうにん
乗客	じょうきゃく
数	すう
全国	ぜんこく
他人	たにん
谷	たに
毎月	まいつき
明後日	みょうごにち
面	めん
流行	りゅうこう
例	れい
明かり	あかり
暗記	あんき
科目	かもく
協力	きょうりょく
幸運	こううん
幸せ	しあわせ
知り合い	しりあい
例える	たとえる
次々	つぎつぎ
問い合わせ	といあわせ
残す	のこす
乗せる	のせる
引き受ける	ひきうける
祭	まつり
回り	まわり
満点	まんてん
満ちる	みちる
向かい	むかい
虫歯	むしば
王	おう
他	た
感	かん
無	む
化	か
両	りょう
内	ない
愛	あい
愛する	あいする
愛情	あいじょう
以降	いこう
依頼	いらい
偉い	えらい
偉大	いだい
囲む	かこむ
意識	いしき
移動	いどう
胃	い
衣服	いふく
違い	ちがい
違反	いはん
医師	いし
一層	いっそう
一般	いっぱん
印	しるし
印刷	いんさつ
印象	いんしょう
永遠	えいえん
鋭い	するどい
液体	えきたい
越す	こす
延期	えんき
演技	えんぎ
演劇	えんげき
演説	えんぜつ
煙	けむり
汚す	よごす
奥	おく
温泉	おんせん
加減	かげん
可愛らしい	かわいらしい
可能	かのう
果実	かじつ
課	か
過ごす	すごす
過去	かこ
過失	かしつ
解く	とく
解ける	とける
解決	かいけつ
解散	かいさん
回復	かいふく
快適	かいてき
害	がい
各	かく
確認	かくにん
覚める	さめる
割る	わる
乾燥	かんそう
巻く	まく
完成	かんせい
完全	かんぜん
完了	かんりょう
患者	かんじゃ
感覚	かんかく
汗	あせ
管理	かんり
缶	かん
観察	かんさつ
観念	かんねん
間違い	まちがい
関心	かんしん
関連	かんれん
含む	ふくむ
願い	ねがい
願う	ねがう
希望	きぼう
機能	きのう
帰宅	きたく
気の毒	きのどく
気候	きこう
記念	きねん
技師	ぎし
疑う	うたがう
疑問	ぎもん
議会	ぎかい
議長	ぎちょう
議論	ぎろん
詰める	つめる
吸収	きゅうしゅう
給料	きゅうりょう
居間	いま
巨大	きょだい
許す	ゆるす
許可	きょか
供給	きょうきゅう
競技	きょうぎ
共通	きょうつう
叫ぶ	さけぶ
強盗	ごうとう
恐らく	おそらく
恐ろしい	おそろしい
恐怖	きょうふ
教師	きょうし
胸	むね
努める	つとめる
禁煙	きんえん
苦痛	くつう
苦労	くろう
備える	そなえる
偶然	ぐうぜん
掘る	ほる
訓練	くんれん
軍	ぐん
傾向	けいこう
敬意	けいい
景気	けいき
経つ	たつ
経営	けいえい
経由	けいゆ
警告	けいこく
芸術	げいじゅつ
劇	げき
劇場	げきじょう
欠席	けっせき
券	けん
建設	けんせつ
建築	けんちく
権利	けんり
肩	かた
見解	けんかい
賢い	かしこい
減らす	へらす
減る	へる
現れる	あらわれる
現金	げんきん
現在	げんざい
現実	げんじつ
現象	げんしょう
現場	げんば
現状	げんじょう
現代	げんだい
限り	かぎり
限る	かぎる
限界	げんかい
個人	こじん
呼び出す	よびだす
呼吸	こきゅう
枯れる	かれる
互い	たがい
誤り	あやまり
誤解	ごかい
交換	こうかん
交際	こうさい
光景	こうけい
公務員	こうむいん
効果	こうか
好み	このみ
好む	このむ
広告	こうこく
更に	さらに
構う	かまう
構成	こうせい
硬い	かたい
航空	こうくう
荒れる	あれる
講演	こうえん
合格	ごうかく
刻む	きざむ
国境	こっきょう
国民	こくみん
腰	こし
骨折	こっせつ
困難	こんなん
婚約	こんやく
混雑	こんざつ
混乱	こんらん
差	さ
差す	さす
差別	さべつ
座席	ざせき
再び	ふたたび
最も	もっとも
最高	さいこう
最終	さいしゅう
最低	さいてい
済ませる	すませる
際	さい
材料	ざいりょう
財産	ざいさん
作成	さくせい
札	さつ
殺す	ころす
散歩	さんぽ
賛成	さんせい
伺う	うかがう
刺す	さす
支える	ささえる
支給	しきゅう
支出	ししゅつ
支店	してん
支配	しはい
支払う	しはらう
死亡	しぼう
資料	しりょう
事件	じけん
事務	じむ
似合う	にあう
時刻	じこく
示す	しめす
自殺	じさつ
辞める	やめる
失う	うしなう
失業	しつぎょう
失望	しつぼう
湿気	しっけ
実現	じつげん
実際	じっさい
主婦	しゅふ
主要	しゅよう
手段	しゅだん
種類	しゅるい
収入	しゅうにゅう
周囲	しゅうい
周辺	しゅうへん
集団	しゅうだん
住宅	じゅうたく
住民	じゅうみん
重要	じゅうよう
宿泊	しゅくはく
祝い	いわい
祝う	いわう
出席	しゅっせき
出版	しゅっぱん
述べる	のべる
順	じゅん
順調	じゅんちょう
順番	じゅんばん
処理	しょり
署名	しょめい
諸	しょ
女優	じょゆう
除く	のぞく
床	ゆか
承認	しょうにん
招く	まねく
照らす	てらす
省く	はぶく
笑顔	えがお
象	ぞう
賞	しょう
昇る	のぼる
上達	じょうたつ
常識	じょうしき
情報	じょうほう
状況	じょうきょう
職	しょく
職業	しょくぎょう
職場	しょくば
触れる	ふれる
食欲	しょくよく
伸びる	のびる
信じる	しんじる
信号	しんごう
信用	しんよう
信頼	しんらい
心臓	しんぞう
深刻	しんこく
申し込む	もうしこむ
真似	まね
神経	しんけい
針	はり
震える	ふるえる
人種	じんしゅ
制限	せいげん
制度	せいど
性	せい
性格	せいかく
性質	せいしつ
成人	せいじん
成績	せいせき
成長	せいちょう
政府	せいふ
生産	せいさん
精神	せいしん
税金	ぜいきん
積む	つむ
積もる	つもる
責める	せめる
責任	せきにん
跡	あと
接する	せっする
設計	せっけい
設備	せつび
説	せつ
絶えず	たえず
絶対	ぜったい
占める	しめる
河	かわ
双子	ふたご
想像	そうぞう
相続	そうぞく
相変わらず	あいかわらず
総	そう
装置	そうち
増す	ます
増加	ぞうか
憎む	にくむ
贈る	おくる
存じる	ぞんじる
存在	そんざい
孫	まご
尊敬	そんけい
尊重	そんちょう
損	そん
損害	そんがい
対象	たいしょう
大臣	だいじん
大陸	たいりく
達する	たっする
単位	たんい
単純	たんじゅん
担当	たんとう
団体	だんたい
知識	ちしき
地位	ちい
地域	ちいき
遅刻	ちこく
仲	なか
仲間	なかま
仲良し	なかよし
駐車	ちゅうしゃ
著者	ちょしゃ
貯金	ちょきん
調査	ちょうさ
頂上	ちょうじょう
直接	ちょくせつ
沈む	しずむ
通り過ぎる	とおりすぎる
通過	つうか
底	そこ
程度	ていど
泥	どろ
適切	てきせつ
適度	てきど
適用	てきよう
天候	てんこう
努力	どりょく
怒鳴る	どなる
倒す	たおす
党	とう
塔	とう
到着	とうちゃく
頭痛	ずつう
動詞	どうし
得る	うる
得意	とくい
毒	どく
突っ込む	つっこむ
突然	とつぜん
届く	とどく
内容	ないよう
南極	なんきょく
日付	ひづけ
任せる	まかせる
認める	みとめる
熱心	ねっしん
熱中	ねっちゅう
燃える	もえる
悩む	なやむ
濃い	こい
農民	のうみん
破る	やぶる
破産	はさん
配達	はいたつ
爆発	ばくはつ
肌	はだ
発達	はったつ
髪の毛	かみのけ
抜く	ぬく
抜ける	ぬける
判断	はんだん
犯罪	はんざい
販売	はんばい
否定	ひてい
悲劇	ひげき
疲れ	つかれ
皮膚	ひふ
被る	かぶる
被害	ひがい
非	ひ
非常	ひじょう
必ずしも	かならずしも
表現	ひょうげん
貧しい	まずしい
瓶	びん
不思議	ふしぎ
不利	ふり
付き合い	つきあい
付ける	つける
夫妻	ふさい
夫人	ふじん
婦人	ふじん
布	ぬの
普段	ふだん
浮かべる	うかべる
舞台	ぶたい
風景	ふうけい
幅	はば
服装	ふくそう
腹	はら
閉じる	とじる
変化	へんか
変更	へんこう
編む	あむ
便	びん
便り	たより
捕まる	つかまる
暮らし	くらし
暮らす	くらす
報告	ほうこく
宝	たから
宝石	ほうせき
抱える	かかえる
方針	ほうしん
方法	ほうほう
法	ほう
法則	ほうそく
訪問	ほうもん
豊か	ゆたか
豊富	ほうふ
棒	ぼう
埋める	うめる
未来	みらい
夢中	むちゅう
命令	めいれい
綿	めん
面接	めんせつ
面倒	めんどう
毛布	もうふ
戻す	もどす
役割	やくわり
約	やく
輸入	ゆにゅう
優れる	すぐれる
優勝	ゆうしょう
勇気	ゆうき
有効	ゆうこう
郵送	ゆうそう
予測	よそく
余る	あまる
余計	よけい
余分	よぶん
与える	あたえる
預かる	あずかる
預ける	あずける
幼い	おさない
幼児	ようじ
容易	ようい
溶ける	とける
要するに	ようするに
要求	ようきゅう
要点	ようてん
要領	ようりょう
理解	りかい
裏切る	うらぎる
陸	りく
両替	りょうがえ
輪	わ
涙	なみだ
冷静	れいせい
恋	こい
恋人	こいびと
連想	れんそう
連続	れんぞく
老人	ろうじん
論じる	ろんじる
論争	ろんそう
論文	ろんぶん
永久	えいきゅう
居る	おる
最中	さいちゅう
鈍い	にぶい
燃やす	もやす
夫婦	ふうふ
平均	へいきん
抱く	いだく
痛み	いたみ
位置	いち
得る	える
収める	おさめる
恐れる	おそれる
降ろす	おろす
替える	かえる
香り	かおり
乾杯	かんぱい
効く	きく
気付く	きづく
寄付	きふ
越える	こえる
凍る	こおる
捜す	さがす
戦い	たたかい
戦う	たたかう
頼る	たよる
手続き	てつづき
飛び込む	とびこむ
年齢	ねんれい
伸ばす	のばす
必死	ひっし
雇う	やとう
郵便	ゆうびん
有利	ゆうり
喜び	よろこび
労働	ろうどう
泊	はく
最	さい
論	ろん
お互い	おたがい
税	ぜい
悪魔	あくま
握る	にぎる
握手	あくしゅ
扱う	あつかう
案	あん
意志	いし
慰める	なぐさめる
異なる	ことなる
異常	いじょう
維持	いじ
井戸	いど
一瞬	いっしゅん
一斉	いっせい
一致	いっち
稲	いね
隠す	かくす
隠れる	かくれる
宇宙	うちゅう
運命	うんめい
影響	えいきょう
栄養	えいよう
援助	えんじょ
猿	さる
遠慮	えんりょ
汚染	おせん
応じる	おうじる
応募	おうぼ
殴る	なぐる
沖	おき
温暖	おんだん
穏やか	おだやか
価格	かかく
価値	かち
家賃	やちん
火災	かさい
稼ぐ	かせぐ
蚊	か
我慢	がまん
芽	め
解釈	かいしゃく
怪我	けが
悔やむ	くやむ
懐かしい	なつかしい
改善	かいぜん
街	がい
拡大	かくだい
覚悟	かくご
株	かぶ
勘定	かんじょう
感謝	かんしゃ
歓迎	かんげい
環境	かんきょう
監督	かんとく
企業	きぎょう
器用	きよう
基礎	きそ
基本	きほん
奇妙	きみょう
既に	すでに
機嫌	きげん
記憶	きおく
貴重	きちょう
輝く	かがやく
鬼	おに
儀式	ぎしき
義務	ぎむ
休暇	きゅうか
休憩	きゅうけい
急激	きゅうげき
救う	すくう
救助	きゅうじょ
教授	きょうじゅ
狂う	くるう
響く	ひびく
筋	すじ
筋肉	きんにく
緊張	きんちょう
金銭	きんせん
金属	きんぞく
金融	きんゆう
繰り返す	くりかえす
軍隊	ぐんたい
刑事	けいじ
契約	けいやく
掲示	けいじ
撃つ	うつ
傑作	けっさく
欠陥	けっかん
穴	あな
結ぶ	むすぶ
結果	けっか
結局	けっきょく
結論	けつろん
件	けん
健康	けんこう
兼ねる	かねる
嫌う	きらう
憲法	けんぽう
懸命	けんめい
検査	けんさ
検討	けんとう
原稿	げんこう
虎	とら
誇り	ほこり
慌てる	あわてる
攻撃	こうげき
考慮	こうりょ
行儀	ぎょうぎ
貢献	こうけん
高価	こうか
豪華	ごうか
克服	こくふく
穀物	こくもつ
裁判	さいばん
酸素	さんそ
姿	すがた
死	し
至る	いたる
詩人	しじん
資源	しげん
飼う	かう
事業	じぎょう
次第	しだい
自慢	じまん
実施	じっし
芝居	しばい
芝生	しばふ
主義	しゅぎ
主張	しゅちょう
種	しゅ
需要	じゅよう
収穫	しゅうかく
宗教	しゅうきょう
就く	つく
就職	しゅうしょく
修正	しゅうせい
修理	しゅうり
臭い	くさい
従う	したがう
従って	したがって
渋滞	じゅうたい
重視	じゅうし
銃	じゅう
出張	しゅっちょう
瞬間	しゅんかん
書斎	しょさい
助け	たすけ
女房	にょうぼう
症状	しょうじょう
衝突	しょうとつ
証明	しょうめい
詳しい	くわしい
障害	しょうがい
挙げる	あげる
揚げる	あげる
上司	じょうし
冗談	じょうだん
条件	じょうけん
状態	じょうたい
譲る	ゆずる
食器	しょっき
食卓	しょくたく
食糧	しょくりょう
信仰	しんこう
侵入	しんにゅう
唇	くちびる
審判	しんぱん
慎重	しんちょう
振り向く	ふりむく
振る	ふる
新鮮	しんせん
申し訳	もうしわけ
真剣	しんけん
真実	しんじつ
診る	みる
診察	しんさつ
推薦	すいせん
睡眠	すいみん
酔う	よう
世紀	せいき
成功	せいこう
整理	せいり
清潔	せいけつ
製造	せいぞう
製品	せいひん
誓う	ちかう
請求	せいきゅう
節約	せつやく
説得	せっとく
絶滅	ぜつめつ
舌	した
専攻	せんこう
選択	せんたく
善	ぜん
素敵	すてき
組織	そしき
訴える	うったえる
喪失	そうしつ
操作	そうさ
巣	す
相撲	すもう
騒ぎ	さわぎ
騒音	そうおん
属する	ぞくする
怠る	おこたる
態度	たいど
滞在	たいざい
逮捕	たいほ
大抵	たいてい
大統領	だいとうりょう
第	だい
奪う	うばう
誕生	たんじょう
知恵	ちえ
張る	はる
眺める	ながめる
通訳	つうやく
釣り	つり
抵抗	ていこう
提案	ていあん
提出	ていしゅつ
笛	ふえ
哲学	てつがく
徹底	てってい
徹夜	てつや
伝統	でんとう
投票	とうひょう
当然	とうぜん
答案	とうあん
統計	とうけい
豆	まめ
同意	どうい
同僚	どうりょう
憧れる	あこがれる
道徳	どうとく
特徴	とくちょう
独身	どくしん
独特	どくとく
独立	どくりつ
虹	にじ
納得	なっとく
俳優	はいゆう
梅	うめ
博士	はかせ
博物館	はくぶつかん
拍手	はくしゅ
迫る	せまる
縛る	しばる
発揮	はっき
発展	はってん
反抗	はんこう
範囲	はんい
批判	ひはん
批評	ひひょう
比較	ひかく
比較的	ひかくてき
秘密	ひみつ
微笑む	ほほえむ
微妙	びみょう
評価	ひょうか
評判	ひょうばん
敷く	しく
腐る	くさる
武器	ぶき
物価	ぶっか
分析	ぶんせき
雰囲気	ふんいき
文句	もんく
塀	へい
保存	ほぞん
崩す	くずす
妨げる	さまたげる
冒険	ぼうけん
幕	まく
魅力	みりょく
無視	むし
無駄	むだ
矛盾	むじゅん
霧	きり
迷惑	めいわく
免許	めんきょ
模様	もよう
黙る	だまる
目標	もくひょう
厄介	やっかい
訳す	やくす
唯一	ゆいいつ
優秀	ゆうしゅう
誘う	さそう
余裕	よゆう
要素	ようそ
翼	つばさ
裸	はだか
嵐	あらし
利益	りえき
理論	りろん
離す	はなす
離れる	はなれる
離婚	りこん
率	りつ
礼儀	れいぎ
劣る	おとる
化粧	けしょう
助言	じょげん
傷	きず
敵	てき
梅雨	つゆ
避ける	さける
描く	えがく
雷	かみなり
飽きる	あきる
怪しい	あやしい
有らゆる	あらゆる
覆う	おおう
丘	おか
影	かげ
陰	かげ
桜	さくら
砂漠	さばく
刺激	しげき
絞る	しぼる
事態	じたい
勧める	すすめる
退屈	たいくつ
蓄える	たくわえる
激しい	はげしい
馬鹿	ばか
引っ張る	ひっぱる
故郷	こきょう
保証	ほしょう
褒める	ほめる
基づく	もとづく
履く	はく
演奏	えんそう
途端	とたん
眺め	ながめ
恵まれる	めぐまれる
級	きゅう
詩	し
氏	し
お喋り	おしゃべり
くっ付く	くっつく
頻りに	しきりに
其れ共	それとも
打つかる	ぶつかる
軈て	やがて
溢れる	あふれる
噂	うわさ
餌	えさ
何時か	いつか
蓋	ふた
丸で	まるで
極	ごく
僅か	わずか
近頃	ちかごろ
繋がる	つながる
繋ぐ	つなぐ
諺	ことわざ
お目出度う	おめでとう
ご覧	ごらん
忽ち	たちまち
左様なら	さようなら
撒く	まく
叱る	しかる
蹴る	ける
従兄弟	いとこ
所謂	いわゆる
拭く	ふく
尻	しり
尻尾	しっぽ
真逆	まさか
親戚	しんせき
遂に	ついに
正に	まさに
生憎	あいにく
羨ましい	うらやましい
漸く	ようやく
掻く	かく
袖	そで
其れでも	それでも
其処で	そこで
揃える	そろえる
態と	わざと
大人しい	おとなしい
叩く	たたく
喋る	しゃべる
直に	じかに
掴む	つかむ
潰す	つぶす
諦める	あきらめる
釘	くぎ
溺れる	おぼれる
兎	うさぎ
兎に角	とにかく
兎も角	ともかく
謎	なぞ
鍋	なべ
如何しても	どうしても
覗く	のぞく
莫大	ばくだい
膝	ひざ
肘	ひじ
紐	ひも
不図	ふと
物凄い	ものすごい
然も	しかも
凡そ	およそ
枕	まくら
妙	みょう
儲ける	もうける
唯	ただ
略	ほぼ
溜まる	たまる
脇	わき
嗅ぐ	かぐ
埃	ほこり
曖昧	あいまい
茹でる	ゆでる
贅沢	ぜいたく
躊躇う	ためらう
騙す	だます
剃る	そる
否	いや
頬	ほお
或る	ある
籠	かご
折角	せっかく
度々	たびたび
匂い	におい
吠える	ほえる
稀	まれ
罹る	かかる
所為	せい
詰まり	つまり
麓	ふもと
彼方此方	あちこち
彼此	あれこれ
伯父さん	おじさん
あら	あら
うろうろ	うろうろ
うんざり	うんざり
おや	おや
すっきり	すっきり
せめて	せめて
下り	くだり
下車	げしゃ
何しろ	なにしろ
学年	がくねん
月日	つきひ
見学	けんがく
見出し	みだし
見本	みほん
高める	たかめる
出入り	でいり
出来上がる	できあがる
小学生	しょうがくせい
上り	のぼり
上る	のぼる
上下	じょうげ
水分	すいぶん
生ずる	しょうずる
生年月日	せいねんがっぴ
前	ぜん
前後	ぜんご
大気	たいき
大小	だいしょう
大木	たいぼく
中間	ちゅうかん
中年	ちゅうねん
長女	ちょうじょ
長男	ちょうなん
東西	とうざい
南北	なんぼく
日の出	ひので
日時	にちじ
入社	にゅうしゃ
分	ぶん
毎	まい
来日	らいにち
下ろす	おろす
何となく	なんとなく
がる	がる
うんと	うんと
それなのに	それなのに
小	しょう
しばしば	しばしば
以後	いご
意地悪	いじわる
引き分け	ひきわけ
映る	うつる
英文	えいぶん
屋外	おくがい
下町	したまち
下品	げひん
家屋	かおく
海洋	かいよう
開会	かいかい
学会	がっかい
学力	がくりょく
帰す	かえす
休業	きゅうぎょう
強引	ごういん
強気	つよき
近代	きんだい
金魚	きんぎょ
空中	くうちゅう
言い出す	いいだす
工事	こうじ
広める	ひろめる
行事	ぎょうじ
行方	ゆくえ
国立	こくりつ
作者	さくしゃ
仕上がる	しあがる
使い	つかい
死体	したい
私立	しりつ
写る	うつる
手前	てまえ
集まる	あつまる
重たい	おもたい
重なる	かさなる
重ねる	かさねる
重力	じゅうりょく
出場	しゅつじょう
上品	じょうひん
心理	しんり
真っ先	まっさき
真空	しんくう
人事	じんじ
水着	みずぎ
生意気	なまいき
青少年	せいしょうねん
送料	そうりょう
大学院	だいがくいん
大工	だいく
題名	だいめい
知人	ちじん
地質	ちしつ
地味	じみ
地名	ちめい
着せる	きせる
中古	ちゅうこ
中世	ちゅうせい
注	ちゅう
転がる	ころがる
電力	でんりょく
東洋	とうよう
同時	どうじ
特色	とくしょく
特長	とくちょう
日帰り	ひがえり
年度	ねんど
売店	ばいてん
売買	ばいばい
発電	はつでん
発売	はつばい
飯	めし
着ける	つける
文体	ぶんたい
歩	ほ
方言	ほうげん
毎度	まいど
名作	めいさく
目安	めやす
目下	めした
問い	とい
夕日	ゆうひ
料	りょう
力強い	ちからづよい
近々	ちかぢか
真っ白	まっしろ
弟子	でし
品	ひん
方々	かたがた
映す	うつす
売れ行き	うれゆき
会館	かいかん
代える	かえる
貸し出し	かしだし
代わる	かわる
着々	ちゃくちゃく
真っ黒	まっくろ
元々	もともと
空き	あき
長引く	ながびく
持ち	もち
気味	ぎみ
館	かん
業	ぎょう
お参り	おまいり
安易	あんい
一定	いってい
引き返す	ひきかえす
羽根	はね
園	えん
温室	おんしつ
加速	かそく
回数	かいすう
回答	かいとう
快晴	かいせい
開通	かいつう
開放	かいほう
貝	かい
外科	げか
外部	がいぶ
角	かく
角度	かくど
学科	がっか
学術	がくじゅつ
活字	かつじ
活力	かつりょく
感想	かんそう
期	き
気配	けはい
記号	きごう
強化	きょうか
教わる	おそわる
局	きょく
曲	きょく
曲げる	まげる
曲線	きょくせん
区分	くぶん
苦情	くじょう
空想	くうそう
形式	けいしき
見直す	みなおす
見当	けんとう
原	はら
原始	げんし
原理	げんり
原料	げんりょう
語学	ごがく
交流	こうりゅう
光線	こうせん
公式	こうしき
公表	こうひょう
口実	こうじつ
校	こう
行列	ぎょうれつ
高等	こうとう
合同	ごうどう
合流	ごうりゅう
国語	こくご
混合	こんごう
作曲	さっきょく
参考	さんこう
算数	さんすう
指定	してい
留まる	とまる
留める	とめる
寺院	じいん
持参	じさん
時速	じそく
次いで	ついで
次ぐ	つぐ
実る	みのる
実感	じっかん
実習	じっしゅう
実物	じつぶつ
実用	じつよう
実力	じつりょく
実例	じつれい
弱点	じゃくてん
主語	しゅご
主役	しゅやく
取り入れる	とりいれる
手首	てくび
受験	じゅけん
終点	しゅうてん
集合	しゅうごう
重点	じゅうてん
重量	じゅうりょう
出勤	しゅっきん
商業	しょうぎょう
商社	しょうしゃ
商店	しょうてん
少数	しょうすう
消化	しょうか
消防	しょうぼう
乗車	じょうしゃ
心身	しんしん
森林	しんりん
深まる	ふかまる
深夜	しんや
真っ暗	まっくら
神様	かみさま
神話	しんわ
親指	おやゆび
進路	しんろ
人命	じんめい
図表	ずひょう
水準	すいじゅん
水平	すいへい
水面	すいめん
水曜	すいよう
勢い	いきおい
正面	しょうめん
線路	せんろ
全集	ぜんしゅう
想	そう
早速	さっそく
体育	たいいく
対立	たいりつ
帯	おび
退院	たいいん
大通り	おおどおり
短期	たんき
短所	たんしょ
断定	だんてい
地帯	ちたい
竹	たけ
直後	ちょくご
直線	ちょくせん
直前	ちょくぜん
追加	ついか
通勤	つうきん
通行	つうこう
通用	つうよう
通路	つうろ
定員	ていいん
定期	ていき
的確	てきかく
天然	てんねん
点数	てんすう
伝記	でんき
田植え	たうえ
電球	でんきゅう
電波	でんぱ
電流	でんりゅう
登場	とうじょう
都心	としん
当日	とうじつ
当番	とうばん
童話	どうわ
内科	ないか
南米	なんべい
日常	にちじょう
能	のう
農村	のうそん
農薬	のうやく
畑	はたけ
発想	はっそう
半島	はんとう
反	はん
番地	ばんち
飛行	ひこう
筆記	ひっき
筆者	ひっしゃ
表紙	ひょうし
負け	まけ
部品	ぶひん
風船	ふうせん
物語る	ものがたる
分量	ぶんりょう
平日	へいじつ
放る	ほうる
方面	ほうめん
防止	ぼうし
防犯	ぼうはん
本部	ほんぶ
満員	まんいん
無数	むすう
名所	めいしょ
名物	めいぶつ
明け方	あけがた
目次	もくじ
夜間	やかん
役者	やくしゃ
役所	やくしょ
役人	やくにん
役目	やくめ
薬局	やっきょく
薬品	やくひん
油断	ゆだん
有無	うむ
予防	よぼう
用語	ようご
理科	りか
留守番	るすばん
列島	れっとう
録音	ろくおん
和	わ
等	とう
両側	りょうがわ
温かい	あたたかい
温める	あたためる
当てはめる	あてはめる
植木	うえき
係わる	かかわる
区切る	くぎる
退く	どく
先頭	せんとう
ため息	ためいき
中身	なかみ
話し合い	はなしあい
反映	はんえい
混ざる	まざる
混じる	まじる
集まり	あつまり
都	と
集	しゅう
移す	うつす
移転	いてん
医療	いりょう
育児	いくじ
運河	うんが
園芸	えんげい
延長	えんちょう
下降	かこう
加熱	かねつ
可	か
可決	かけつ
課税	かぜい
課程	かてい
貨物	かもつ
過程	かてい
過半数	かはんすう
解く	ほどく
解説	かいせつ
解答	かいとう
解放	かいほう
改めて	あらためて
改める	あらためる
改札	かいさつ
改正	かいせい
改造	かいぞう
灰	はい
灰色	はいいろ
各自	かくじ
各地	かくち
格別	かくべつ
覚ます	さます
官庁	かんちょう
缶詰	かんづめ
観測	かんそく
関西	かんさい
関東	かんとう
含める	ふくめる
危うい	あやうい
寄せる	よせる
幾	いく
期限	きげん
機関	きかん
気圧	きあつ
規律	きりつ
起床	きしょう
議員	ぎいん
詰まる	つまる
客席	きゃくせき
給与	きゅうよ
漁業	ぎょぎょう
漁師	りょうし
競馬	けいば
境	さかい
境界	きょうかい
極力	きょくりょく
務める	つとめる
近寄る	ちかよる
区域	くいき
群れ	むれ
形容詞	けいようし
敬語	けいご
警備	けいび
芸能	げいのう
血圧	けつあつ
血液	けつえき
月給	げっきゅう
月末	げつまつ
県庁	けんちょう
見舞う	みまう
軒	のき
現す	あらわす
現に	げんに
限度	げんど
個体	こたい
固まる	かたまる
交差	こうさ
候補	こうほ
公害	こうがい
公共	こうきょう
公務	こうむ
効力	こうりょく
工芸	こうげい
工夫	くふう
構造	こうぞう
肯定	こうてい
荒い	あらい
講師	こうし
鉱物	こうぶつ
香水	こうすい
高層	こうそう
国籍	こくせき
再	さい
再三	さいさん
採点	さいてん
在学	ざいがく
作法	さほう
雑音	ざつおん
散らす	ちらす
散る	ちる
産地	さんち
刺身	さしみ
子孫	しそん
思い込む	おもいこむ
脂	あぶら
資本	しほん
児童	じどう
自治	じち
自宅	じたく
湿る	しめる
湿度	しつど
実績	じっせき
社説	しゃせつ
車輪	しゃりん
終了	しゅうりょう
祝日	しゅくじつ
初歩	しょほ
書籍	しょせき
勝敗	しょうはい
床屋	とこや
承る	うけたまわる
消毒	しょうどく
省略	しょうりゃく
賞金	しょうきん
賞品	しょうひん
蒸気	じょうき
職人	しょくにん
延びる	のびる
心得る	こころえる
真似る	まねる
制作	せいさく
姓	せい
性能	せいのう
性別	せいべつ
成分	せいぶん
成立	せいりつ
政党	せいとう
清掃	せいそう
生存	せいぞん
税関	ぜいかん
接近	せっきん
接続	せつぞく
先祖	せんぞ
先程	さきほど
占う	うらなう
泉	いずみ
浅い	あさい
祖先	そせん
争う	あらそう
相違	そうい
窓口	まどぐち
増減	ぞうげん
増大	ぞうだい
束	たば
測定	そくてい
測量	そくりょう
体制	たいせい
対照	たいしょう
代名詞	だいめいし
大戦	たいせん
宅	たく
担ぐ	かつぐ
探る	さぐる
団地	だんち
段階	だんかい
着替え	きがえ
着替える	きがえる
中絶	ちゅうぜつ
中途	ちゅうと
昼寝	ひるね
貯蔵	ちょぞう
超過	ちょうか
頂点	ちょうてん
通貨	つうか
通信	つうしん
停止	ていし
停車	ていしゃ
停電	ていでん
盗難	とうなん
灯油	とうゆ
頭脳	ずのう
突き	つき
突く	つく
日程	にってい
熱帯	ねったい
濃度	のうど
農産物	のうさんぶつ
破れる	やぶれる
拝見	はいけん
背負う	せおう
薄暗い	うすぐらい
判事	はんじ
反省	はんせい
革	かわ
美容	びよう
不可	ふか
付近	ふきん
浮く	うく
武道	ぶどう
副	ふく
複数	ふくすう
仏	ほとけ
分解	ぶんかい
分布	ぶんぷ
文芸	ぶんげい
並行	へいこう
閉会	へいかい
片道	かたみち
編	へん
捕る	とる
補う	おぎなう
募集	ぼしゅう
包装	ほうそう
報	ほう
方程式	ほうていしき
暴れる	あばれる
枚数	まいすう
未	み
民間	みんかん
亡くす	なくす
無限	むげん
名刺	めいし
名詞	めいし
面積	めんせき
木材	もくざい
目印	めじるし
輸送	ゆそう
夕刊	ゆうかん
予備	よび
予報	よほう
溶かす	とかす
溶け込む	とけこむ
用途	ようと
頼もしい	たのもしい
乱暴	らんぼう
利害	りがい
略す	りゃくす
流域	りゅういき
粒	つぶ
冷める	さめる
冷やす	ひやす
冷凍	れいとう
連合	れんごう
湾	わん
傾く	かたむく
紅葉	こうよう
足跡	あしあと
代替	だいたい
値	ね
銅	どう
抱く	だく
浴衣	ゆかた
押さえる	おさえる
換える	かえる
個所	かしょ
共同	きょうどう
組み合わせ	くみあわせ
超える	こえる
住居	じゅうきょ
すれ違う	すれちがう
相互	そうご
各々	おのおの
続々	ぞくぞく
炭鉱	たんこう
短編	たんぺん
造る	つくる
出掛ける	でかける
採る	とる
治す	なおす
延ばす	のばす
乗り換え	のりかえ
測る	はかる
挟む	はさむ
果たして	はたして
引っ越し	ひっこし
増やす	ふやす
編集	へんしゅう
干す	ほす
見慣れる	みなれる
割引	わりびき
欧米	おうべい
水産	すいさん
段	だん
団	だん
隻	せき
現	げん
位	い
戦	せん
省	しょう
領	りょう
産	さん
付	づけ
済み	ずみ
家	か
哀れ	あわれ
圧縮	あっしゅく
案外	あんがい
意義	いぎ
為す	なす
為替	かわせ
一応	いちおう
衛星	えいせい
宴会	えんかい
艶	つや
凹む	へこむ
往復	おうふく
応援	おうえん
応対	おうたい
応用	おうよう
恩	おん
恩恵	おんけい
下旬	げじゅん
仮定	かてい
嫁	よめ
架空	かくう
花嫁	はなよめ
過剰	かじょう
街角	まちかど
拡充	かくじゅう
拡張	かくちょう
殻	から
確信	かくしん
確率	かくりつ
隔てる	へだてる
学級	がっきゅう
楽器	がっき
活躍	かつやく
勘	かん
勘違い	かんちがい
感激	かんげき
看板	かんばん
緩い	ゆるい
鑑賞	かんしょう
間隔	かんかく
器具	きぐ
基地	きち
基盤	きばん
飢える	うえる
休養	きゅうよう
及ぼす	およぼす
恐縮	きょうしゅく
教養	きょうよう
興奮	こうふん
驚かす	おどろかす
句	く
郡	ぐん
系統	けいとう
継続	けいぞく
堅い	かたい
研修	けんしゅう
謙虚	けんきょ
賢明	けんめい
顕微鏡	けんびきょう
厳重	げんじゅう
古典	こてん
娯楽	ごらく
後輩	こうはい
ご無沙汰	ごぶさた
御覧	ごらん
公衆	こうしゅう
功績	こうせき
好き嫌い	すききらい
攻める	せめる
校舎	こうしゃ
綱	つな
項目	こうもく
高級	こうきゅう
恨み	うらみ
恨む	うらむ
鎖	くさり
催し	もよおし
砕く	くだく
削る	けずる
削除	さくじょ
索引	さくいん
撮影	さつえい
殺人	さつじん
司会	しかい
姿勢	しせい
市場	しじょう
氏名	しめい
紙幣	しへい
紫	むらさき
磁石	じしゃく
自衛	じえい
執筆	しっぴつ
斜め	ななめ
煮る	にる
受け入れる	うけいれる
寿命	じゅみょう
就任	しゅうにん
修繕	しゅうぜん
醜い	みにくい
縦	たて
縮める	ちぢめる
縮小	しゅくしょう
循環	じゅんかん
純粋	じゅんすい
巡る	めぐる
順序	じゅんじょ
初級	しょきゅう
初旬	しょじゅん
助教授	じょきょうじゅ
将棋	しょうぎ
小遣い	こづかい
焦点	しょうてん
鐘	かね
上級	じょうきゅう
上旬	じょうじゅん
載る	のる
蒸し暑い	むしあつい
飾り	かざり
振り	ふり
新幹線	しんかんせん
申請	しんせい
診断	しんだん
酢	す
図鑑	ずかん
垂直	すいちょく
推定	すいてい
水素	すいそ
杉	すぎ
澄む	すむ
寸法	すんぽう
整備	せいび
製作	せいさく
西暦	せいれき
惜しい	おしい
先端	せんたん
宣伝	せんでん
洗剤	せんざい
素人	しろうと
素直	すなお
創作	そうさく
倉庫	そうこ
爽やか	さわやか
葬式	そうしき
遭う	あう
太鼓	たいこ
妥当	だとう
体系	たいけい
体操	たいそう
対策	たいさく
滝	たき
但し	ただし
脱線	だっせん
弾	たま
地盤	じばん
中旬	ちゅうじゅん
丁目	ちょうめ
張り切る	はりきる
彫る	ほる
彫刻	ちょうこく
調整	ちょうせい
調節	ちょうせつ
定価	ていか
典型	てんけい
天才	てんさい
展開	てんかい
吐き気	はきけ
吐く	はく
統一	とういつ
透明	とうめい
瞳	ひとみ
峠	とうげ
特殊	とくしゅ
独り	ひとり
独り言	ひとりごと
縄	なわ
能率	のうりつ
派手	はで
俳句	はいく
鉢	はち
発射	はっしゃ
非難	ひなん
標識	ひょうしき
標準	ひょうじゅん
標本	ひょうほん
評論	ひょうろん
敷地	しきち
普及	ふきゅう
噴火	ふんか
文献	ぶんけん
文脈	ぶんみゃく
兵隊	へいたい
平凡	へいぼん
別荘	べっそう
保健	ほけん
包丁	ほうちょう
崩れる	くずれる
泡	あわ
縫う	ぬう
望遠鏡	ぼうえんきょう
膨らむ	ふくらむ
墨	すみ
本気	ほんき
盆	ぼん
摩擦	まさつ
免税	めんぜい
矢印	やじるし
愉快	ゆかい
只	ただ
幼稚	ようち
幼稚園	ようちえん
容器	ようき
要旨	ようし
浴室	よくしつ
欄	らん
寮	りょう
臨時	りんじ
鈴	すず
廊下	ろうか
冠	かんむり
脅かす	おどかす
消耗	しょうもう
天皇	てんのう
武士	ぶし
牧場	ぼくじょう
納める	おさめる
塊	かたまり
基準	きじゅん
悔しい	くやしい
炊く	たく
直径	ちょっけい
手帳	てちょう
整う	ととのう
載せる	のせる
響き	ひびき
付属	ふぞく
膨大	ぼうだい
湧く	わく
潜る	もぐる
沿い	ぞい
岬	みさき
やむを得ない	やむをえない
栓	せん
密	みつ
御洒落	おしゃれ
飴	あめ
一旦	いったん
因る	よる
下らない	くだらない
咳	せき
釜	かま
瓦	かわら
堪える	こらえる
汲む	くむ
蕎麦	そば
稽古	けいこ
繋がり	つながり
繋げる	つなげる
隙間	すきま
桁	けた
呉れ呉れも	くれぐれも
行成	いきなり
擦る	こする
疾っくに	とっくに
従姉妹	いとこ
狙う	ねらう
遡る	さかのぼる
揃う	そろう
潰れる	つぶれる
爪	つめ
吊る	つる
這う	はう
卑怯	ひきょう
被せる	かぶせる
撫でる	なでる
呆れる	あきれる
飽くまで	あくまで
姪	めい
儲かる	もうかる
餅	もち
流石	さすが
溜める	ためる
零れる	こぼれる
丼	どんぶり
唸る	うなる
嵌める	はめる
巫山戯る	ふざける
痒い	かゆい
睨む	にらむ
稍	やや
諄い	くどい
饂飩	うどん
或いは	あるいは
愈々	いよいよ
御数	おかず
切掛	きっかけ
芯	しん
一まず	ひとまず
物体無い	もったいない
蘇る	よみがえる
目出度い	めでたい
咥える	くわえる
生る	なる
注ぐ	つぐ
頷く	うなずく
あっさり	あっさり
いざ	いざ
きちっと	きちっと
きっちり	きっちり
くっきり	くっきり
ぐっと	ぐっと
しょっちゅう	しょっちゅう
じっくり	じっくり
すんなり	すんなり
てっきり	てっきり
でかい	でかい
どうにか	どうにか
どうやら	どうやら
ひょっと	ひょっと
ふらふら	ふらふら
ぶらぶら	ぶらぶら
ほっと	ほっと
ぼやく	ぼやく
ややこしい	ややこしい
ゆとり	ゆとり
なんだかんだ	なんだかんだ
入る	いる
はる	はる
見方	みかた
公開	こうかい
持てる	もてる
答	こたえ
動	どう
同	どう
読者	どくしゃ
問答	もんどう
有	ゆう
音	おん
風車	かざぐるま
仕上げ	しあげ
引き下げる	ひきさげる
着	ぎ
重	じゅう
一部	いちぶ
引き取る	ひきとる
苦しめる	くるしめる
向き	むき
私鉄	してつ
実質	じっしつ
商	しょう
申し出	もうしで
相	あい
電線	でんせん
流	りゅう
交わす	かわす
実情	じつじょう
演習	えんしゅう
下位	かい
巻	まき
期末	きまつ
喫茶	きっさ
権	けん
雇用	こよう
児	こ
指示	しじ
周	しゅう
初	はつ
蒸す	むす
造船	ぞうせん
兆	ちょう
内臓	ないぞう
符号	ふごう
了	りょう
付き	つき
埋まる	うずまる
兆し	きざし
仕掛け	しかけ
損なう	そこなう
割り当て	わりあて
頼み	たのみ
明白	めいはく
忠実	ちゅうじつ
悪	あく
悪化	あっか
圧倒	あっとう
圧迫	あっぱく
圧力	あつりょく
扱い	あつかい
暗殺	あんさつ
依然	いぜん
委託	いたく
意図	いと
意地	いじ
異議	いぎ
異動	いどう
異論	いろん
移行	いこう
移住	いじゅう
移民	いみん
衣装	いしょう
衣料	いりょう
遺跡	いせき
医院	いいん
育ち	そだち
一括	いっかつ
一切	いっさい
一帯	いったい
一変	いっぺん
一律	いちりつ
一連	いちれん
印鑑	いんかん
渦	うず
運営	うんえい
運賃	うんちん
運搬	うんぱん
運輸	うんゆ
運用	うんよう
映像	えいぞう
栄える	さかえる
英雄	えいゆう
衛生	えいせい
沿岸	えんがん
沿線	えんせん
演出	えんしゅつ
縁	えん
鉛	なまり
応急	おうきゅう
黄金	おうごん
下痢	げり
化合	かごう
化石	かせき
何より	なにより
加工	かこう
加入	かにゅう
加味	かみ
家計	かけい
家畜	かちく
果て	はて
河川	かせん
火星	かせい
花粉	かふん
荷	に
課題	かだい
過ち	あやまち
過疎	かそ
介護	かいご
介入	かいにゅう
会見	かいけん
会談	かいだん
解ける	ほどける
解除	かいじょ
解剖	かいぼう
回収	かいしゅう
回路	かいろ
改革	かいかく
改修	かいしゅう
改定	かいてい
改良	かいりょう
海峡	かいきょう
開催	かいさい
開拓	かいたく
開発	かいはつ
階級	かいきゅう
階層	かいそう
外貨	がいか
外観	がいかん
外相	がいしょう
外来	がいらい
概念	がいねん
街頭	がいとう
街道	かいどう
各種	かくしゅ
拡散	かくさん
格差	かくさ
核	かく
核心	かくしん
獲得	かくとく
確定	かくてい
確保	かくほ
確立	かくりつ
革新	かくしん
革命	かくめい
学芸	がくげい
学歴	がくれき
楽観	らっかん
楽譜	がくふ
活発	かっぱつ
叶う	かなう
叶える	かなえる
株式	かぶしき
刊行	かんこう
勧告	かんこく
勧誘	かんゆう
耐える	たえる
堪える	たえる
官僚	かんりょう
寛容	かんよう
干渉	かんしょう
幹線	かんせん
幹部	かんぶ
感慨	かんがい
感触	かんしょく
感染	かんせん
慣行	かんこう
慣習	かんしゅう
換算	かんさん
歓声	かんせい
監視	かんし
看護	かんご
簡易	かんい
簡素	かんそ
緩める	ゆるめる
緩やか	ゆるやか
緩和	かんわ
観	かん
観点	かんてん
貫く	つらぬく
還元	かんげん
関税	かんぜい
関与	かんよ
頑固	がんこ
企画	きかく
危機	きき
喜劇	きげき
基金	ききん
既婚	きこん
期日	きじつ
機構	きこう
気軽	きがる
気質	きしつ
気象	きしょう
祈り	いのり
規格	きかく
規制	きせい
規定	きてい
規模	きぼ
規約	きやく
記す	しるす
記載	きさい
記述	きじゅつ
貴族	きぞく
起点	きてん
軌道	きどう
偽造	ぎぞう
戯曲	ぎきょく
技	わざ
技能	ぎのう
犠牲	ぎせい
疑惑	ぎわく
義理	ぎり
議案	ぎあん
議決	ぎけつ
議題	ぎだい
客観	きゃっかん
脚本	きゃくほん
逆転	ぎゃくてん
休める	やすめる
及ぶ	およぶ
宮殿	きゅうでん
弓	ゆみ
救い	すくい
救援	きゅうえん
救済	きゅうさい
究極	きゅうきょく
給食	きゅうしょく
居住	きょじゅう
拒否	きょひ
許容	きょよう
距離	きょり
漁船	ぎょせん
享受	きょうじゅ
共感	きょうかん
協会	きょうかい
協議	きょうぎ
協調	きょうちょう
協定	きょうてい
強める	つよめる
強硬	きょうこう
強行	きょうこう
強制	きょうせい
強烈	きょうれつ
教え	おしえ
教科	きょうか
教訓	きょうくん
教材	きょうざい
脅迫	きょうはく
郷土	きょうど
驚き	おどろき
驚異	きょうい
業者	ぎょうしゃ
業績	ぎょうせき
業務	ぎょうむ
極めて	きわめて
極端	きょくたん
勤務	きんむ
勤労	きんろう
均衡	きんこう
緊急	きんきゅう
近郊	きんこう
区	く
区間	くかん
区切り	くぎり
空間	くうかん
群	ぐん
軍事	ぐんじ
軍備	ぐんび
傾ける	かたむける
傾斜	けいしゃ
刑	けい
契機	けいき
形成	けいせい
形態	けいたい
掲げる	かかげる
掲載	けいさい
携帯	けいたい
系	けい
経る	へる
経緯	けいい
経過	けいか
経費	けいひ
経歴	けいれき
経路	けいろ
茎	くき
警戒	けいかい
軽減	けいげん
劇団	げきだん
激励	げきれい
欠く	かく
決意	けつい
決議	けつぎ
決算	けっさん
決勝	けっしょう
決断	けつだん
結核	けっかく
結晶	けっしょう
結成	けっせい
結束	けっそく
血管	けっかん
健全	けんぜん
圏	けん
検事	けんじ
権威	けんい
権限	けんげん
権力	けんりょく
見地	けんち
基	もと
元年	がんねん
原型	げんけい
原作	げんさく
原子	げんし
原則	げんそく
原点	げんてん
原爆	げんばく
原油	げんゆ
厳密	げんみつ
減少	げんしょう
源	みなもと
現行	げんこう
現地	げんち
言論	げんろん
限定	げんてい
個性	こせい
個別	こべつ
古代	こだい
固める	かためる
固定	こてい
固有	こゆう
孤児	こじ
孤独	こどく
孤立	こりつ
戸籍	こせき
故	こ
故人	こじん
後退	こうたい
護衛	ごえい
交互	こうご
交渉	こうしょう
交付	こうふ
公	おおやけ
公演	こうえん
公然	こうぜん
公団	こうだん
公認	こうにん
公募	こうぼ
公用	こうよう
公立	こうりつ
効率	こうりつ
口頭	こうとう
向上	こうじょう
いい加減	いいかげん
好ましい	このましい
好意	こうい
好調	こうちょう
好評	こうひょう
工学	こうがく
工作	こうさく
巧み	たくみ
巧妙	こうみょう
抗議	こうぎ
拘束	こうそく
控える	ひかえる
控除	こうじょ
構える	かまえる
構想	こうそう
洪水	こうずい
耕作	こうさく
考古学	こうこがく
航海	こうかい
行為	こうい
行進	こうしん
行政	ぎょうせい
講習	こうしゅう
購入	こうにゅう
鉱業	こうぎょう
鉱山	こうざん
高まる	たかまる
高原	こうげん
合意	ごうい
合間	あいま
合唱	がっしょう
合成	ごうせい
合致	がっち
国交	こっこう
国産	こくさん
国防	こくぼう
国有	こくゆう
国連	こくれん
黒字	くろじ
込める	こめる
昆虫	こんちゅう
根拠	こんきょ
根本	こんぽん
根底	こんてい
差額	さがく
詐欺	さぎ
再会	さいかい
再建	さいけん
再現	さいげん
再生	さいせい
再発	さいはつ
最善	さいぜん
採決	さいけつ
採算	さいさん
採択	さいたく
採用	さいよう
栽培	さいばい
災害	さいがい
細菌	さいきん
細胞	さいぼう
裁く	さばく
在庫	ざいこ
財	ざい
財源	ざいげん
財政	ざいせい
作	さく
作戦	さくせん
作用	さよう
削減	さくげん
策	さく
雑貨	ざっか
参議院	さんぎいん
参照	さんしょう
山岳	さんがく
産物	さんぶつ
酸	さん
酸化	さんか
残高	ざんだか
残酷	ざんこく
仕上がり	しあがり
仕様	しよう
使命	しめい
司法	しほう
始末	しまつ
志	こころざし
志向	しこう
志望	しぼう
思考	しこう
指揮	しき
指摘	してき
指令	しれい
支持	しじ
施設	しせつ
死刑	しけい
脂肪	しぼう
視覚	しかく
視察	しさつ
視点	してん
視野	しや
資格	しかく
資金	しきん
資産	しさん
賜る	たまわる
雌	めす
飼育	しいく
歯科	しか
事項	じこう
事前	じぜん
事柄	ことがら
持続	じぞく
時差	じさ
治安	ちあん
治療	ちりょう
磁気	じき
自覚	じかく
自己	じこ
自在	じざい
自主	じしゅ
自立	じりつ
辞職	じしょく
辞退	じたい
軸	じく
質疑	しつぎ
実家	じっか
実践	じっせん
実態	じったい
芝	しば
斜面	しゃめん
若干	じゃっかん
弱	じゃく
主	ぬし
主演	しゅえん
主権	しゅけん
主催	しゅさい
主食	しゅしょく
主人公	しゅじんこう
主体	しゅたい
主題	しゅだい
主導	しゅどう
主任	しゅにん
取り巻く	とりまく
取り除く	とりのぞく
取り付ける	とりつける
取材	しゅざい
守備	しゅび
手軽	てがる
手元	てもと
手順	てじゅん
手法	しゅほう
狩り	かり
趣	おもむき
趣旨	しゅし
首脳	しゅのう
受け止める	うけとめる
受け入れ	うけいれ
樹木	じゅもく
樹立	じゅりつ
収益	しゅうえき
収支	しゅうし
収容	しゅうよう
周期	しゅうき
就業	しゅうぎょう
修了	しゅうりょう
終始	しゅうし
衆議院	しゅうぎいん
襲う	おそう
襲撃	しゅうげき
集計	しゅうけい
住	じゅう
充実	じゅうじつ
従事	じゅうじ
従来	じゅうらい
柔軟	じゅうなん
宿命	しゅくめい
塾	じゅく
出演	しゅつえん
出血	しゅっけつ
出現	しゅつげん
出産	しゅっさん
出世	しゅっせ
出動	しゅつどう
出費	しゅっぴ
出品	しゅっぴん
盾	たて
処置	しょち
処罰	しょばつ
処分	しょぶん
所在	しょざい
所持	しょじ
所属	しょぞく
所定	しょてい
所得	しょとく
所有	しょゆう
庶民	しょみん
書評	しょひょう
諸君	しょくん
女史	じょし
除外	じょがい
勝手	かって
勝利	しょうり
奨励	しょうれい
小児科	しょうにか
小切手	こぎって
小柄	こがら
承諾	しょうだく
昇進	しょうしん
沼	ぬま
照明	しょうめい
症	しょう
衝撃	しょうげき
証拠	しょうこ
証言	しょうげん
証人	しょうにん
詳細	しょうさい
象徴	しょうちょう
障る	さわる
上がり	あがり
上位	じょうい
上演	じょうえん
上空	じょうくう
上昇	じょうしょう
上陸	じょうりく
丈	たけ
情	じょう
情勢	じょうせい
情熱	じょうねつ
条約	じょうやく
譲歩	じょうほ
職員	しょくいん
職務	しょくむ
色彩	しきさい
信者	しんじゃ
審議	しんぎ
審査	しんさ
心情	しんじょう
心地	ここち
心中	しんじゅう
振り返る	ふりかえる
振興	しんこう
振動	しんどう
新興	しんこう
新婚	しんこん
新人	しんじん
新築	しんちく
新入生	しんにゅうせい
深める	ふかめる
申告	しんこく
真珠	しんじゅ
真相	しんそう
真理	しんり
紳士	しんし
親しむ	したしむ
親善	しんぜん
診療	しんりょう
身の回り	みのまわり
進化	しんか
進行	しんこう
進出	しんしゅつ
進展	しんてん
人格	じんかく
人材	じんざい
人質	ひとじち
人体	じんたい
人柄	ひとがら
人民	じんみん
迅速	じんそく
推進	すいしん
水田	すいでん
世帯	せたい
世代	せだい
是正	ぜせい
制	せい
制裁	せいさい
制定	せいてい
制服	せいふく
制約	せいやく
勢力	せいりょく
成り立つ	なりたつ
成果	せいか
成熟	せいじゅく
政権	せいけん
政策	せいさく
整える	ととのえる
正解	せいかい
正規	せいき
正義	せいぎ
正常	せいじょう
正体	しょうたい
正当	せいとう
生涯	しょうがい
盛る	もる
精密	せいみつ
聖書	せいしょ
声明	せいめい
誠実	せいじつ
青春	せいしゅん
静止	せいし
税務署	ぜいむしょ
責務	せきむ
赤字	あかじ
切ない	せつない
切実	せつじつ
接触	せっしょく
折	おり
設置	せっち
設定	せってい
設立	せつりつ
節	せつ
説く	とく
仙	せん
先行	せんこう
先着	せんちゃく
占領	せんりょう
宣言	せんげん
戦術	せんじゅつ
戦闘	せんとう
戦力	せんりょく
繊維	せんい
船舶	せんぱく
選挙	せんきょ
選考	せんこう
鮮やか	あざやか
前提	ぜんてい
前例	ぜんれい
措置	そち
素材	そざい
素朴	そぼく
組み合わせる	くみあわせる
組み込む	くみこむ
訴訟	そしょう
阻む	はばむ
阻止	そし
僧	そう
創刊	そうかん
創造	そうぞう
創立	そうりつ
壮大	そうだい
捜査	そうさ
捜索	そうさく
操縦	そうじゅう
争い	あらそい
相応しい	ふさわしい
相場	そうば
相対	そうたい
総会	そうかい
装飾	そうしょく
装備	そうび
走行	そうこう
送金	そうきん
騒動	そうどう
像	ぞう
増強	ぞうきょう
増進	ぞうしん
促進	そくしん
側面	そくめん
速やか	すみやか
存続	そんぞく
損失	そんしつ
他方	たほう
多様	たよう
妥協	だきょう
打開	だかい
打撃	だげき
体格	たいかく
体験	たいけん
体力	たいりょく
対応	たいおう
対決	たいけつ
対抗	たいこう
対処	たいしょ
対談	たいだん
対等	たいとう
対面	たいめん
対話	たいわ
待遇	たいぐう
待望	たいぼう
態勢	たいせい
退職	たいしょく
台本	だいほん
大衆	たいしゅう
大胆	だいたん
大幅	おおはば
大方	おおかた
達成	たっせい
脱出	だっしゅつ
脱退	だったい
単一	たんいつ
単調	たんちょう
単独	たんどく
嘆く	なげく
炭素	たんそ
短歌	たんか
短縮	たんしゅく
短大	たんだい
団結	だんけつ
弾力	だんりょく
断言	だんげん
知的	ちてき
地形	ちけい
地元	じもと
地獄	じごく
地主	じぬし
恥	はじ
築く	きずく
畜産	ちくさん
蓄積	ちくせき
秩序	ちつじょ
着工	ちゃっこう
着目	ちゃくもく
着陸	ちゃくりく
中継	ちゅうけい
中枢	ちゅうすう
中断	ちゅうだん
中毒	ちゅうどく
中立	ちゅうりつ
抽選	ちゅうせん
著書	ちょしょ
著名	ちょめい
徴収	ちょうしゅう
挑戦	ちょうせん
潮	しお
腸	ちょう
調べ	しらべ
調印	ちょういん
調停	ちょうてい
調理	ちょうり
調和	ちょうわ
長官	ちょうかん
長編	ちょうへん
直面	ちょくめん
沈黙	ちんもく
賃金	ちんぎん
津波	つなみ
墜落	ついらく
追い込む	おいこむ
追及	ついきゅう
追跡	ついせき
追放	ついほう
痛感	つうかん
通常	つうじょう
停滞	ていたい
堤防	ていぼう
定める	さだめる
定義	ていぎ
定年	ていねん
提供	ていきょう
提携	ていけい
提示	ていじ
訂正	ていせい
摘む	つむ
的	まと
適応	てきおう
鉄鋼	てっこう
天	てん
天井	てんじょう
天下	てんか
天国	てんごく
天体	てんたい
展示	てんじ
展望	てんぼう
転じる	てんじる
転換	てんかん
転勤	てんきん
転落	てんらく
点検	てんけん
伝説	でんせつ
伝達	でんたつ
田園	でんえん
電源	でんげん
吐く	つく
徒歩	とほ
斗	と
登校	とうこう
登録	とうろく
途上	とじょう
土台	どだい
土俵	どひょう
土木	どぼく
倒産	とうさん
投資	とうし
投入	とうにゅう
棟	とう
当て	あて
当選	とうせん
統合	とうごう
統治	とうち
統制	とうせい
到達	とうたつ
討議	とうぎ
討論	とうろん
踏まえる	ふまえる
逃走	とうそう
逃亡	とうぼう
陶器	とうき
動き	うごき
動員	どういん
動機	どうき
動向	どうこう
動揺	どうよう
同居	どうきょ
同士	どうし
同志	どうし
同情	どうじょう
同調	どうちょう
導く	みちびく
導入	どうにゅう
道場	どうじょう
得点	とくてん
特許	とっきょ
特権	とっけん
特産	とくさん
特集	とくしゅう
特有	とくゆう
独裁	どくさい
独自	どくじ
独占	どくせん
突破	とっぱ
内閣	ないかく
内緒	ないしょ
内心	ないしん
内蔵	ないぞう
内部	ないぶ
内訳	うちわけ
内陸	ないりく
難	なん
肉体	にくたい
日の丸	ひのまる
乳	ちち
入手	にゅうしゅ
入賞	にゅうしょう
入浴	にゅうよく
尿	にょう
任す	まかす
任務	にんむ
任命	にんめい
妊娠	にんしん
認識	にんしき
熱意	ねつい
念	ねん
念願	ねんがん
燃焼	ねんしょう
燃料	ねんりょう
悩ます	なやます
納入	のうにゅう
脳	のう
農場	のうじょう
農地	のうち
把握	はあく
派	は
派遣	はけん
破壊	はかい
廃棄	はいき
廃止	はいし
排除	はいじょ
排水	はいすい
敗戦	はいせん
敗北	はいぼく
背景	はいけい
背後	はいご
肺	はい
配給	はいきゅう
配置	はいち
配布	はいふ
配分	はいぶん
配慮	はいりょ
倍率	ばいりつ
賠償	ばいしょう
迫害	はくがい
爆弾	ばくだん
爆破	ばくは
発掘	はっくつ
発言	はつげん
発作	ほっさ
発生	はっせい
発病	はつびょう
罰	ばつ
判決	はんけつ
判定	はんてい
半端	はんぱ
反応	はんのう
反響	はんきょう
反撃	はんげき
反発	はんぱつ
反乱	はんらん
班	はん
繁栄	はんえい
繁殖	はんしょく
晩年	ばんねん
否決	ひけつ
彼等	かれら
悲観	ひかん
悲惨	ひさん
悲鳴	ひめい
扉	とびら
比重	ひじゅう
比率	ひりつ
比例	ひれい
疲労	ひろう
秘書	ひしょ
避難	ひなん
非行	ひこう
尾	お
美	び
美術	びじゅつ
匹敵	ひってき
票	ひょう
描写	びょうしゃ
苗	なえ
品質	ひんしつ
品種	ひんしゅ
浜	はま
貧困	ひんこん
頻繁	ひんぱん
敏感	びんかん
不可欠	ふかけつ
不況	ふきょう
不景気	ふけいき
不在	ふざい
不審	ふしん
不振	ふしん
不調	ふちょう
不当	ふとう
不動産	ふどうさん
不服	ふふく
不明	ふめい
不良	ふりょう
富	とみ
扶養	ふよう
腐敗	ふはい
負う	おう
負債	ふさい
負傷	ふしょう
負担	ふたん
赴く	おもむく
赴任	ふにん
武装	ぶそう
武力	ぶりょく
舞う	まう
部下	ぶか
部門	ぶもん
封鎖	ふうさ
風俗	ふうぞく
風土	ふうど
復活	ふっかつ
復旧	ふっきゅう
復興	ふっこう
福	ふく
福祉	ふくし
複合	ふくごう
覆す	くつがえす
物資	ぶっし
物体	ぶったい
分散	ぶんさん
分子	ぶんし
分担	ぶんたん
分配	ぶんぱい
分離	ぶんり
分裂	ぶんれつ
紛争	ふんそう
文化財	ぶんかざい
兵器	へいき
兵士	へいし
平常	へいじょう
柄	え
並びに	ならびに
閉鎖	へいさ
偏	へん
偏見	へんけん
変革	へんかく
変遷	へんせん
変動	へんどう
返還	へんかん
返済	へんさい
便宜	べんぎ
弁	べん
弁護	べんご
弁論	べんろん
保つ	たもつ
保育	ほいく
保管	ほかん
保険	ほけん
保護	ほご
保守	ほしゅ
捕獲	ほかく
捕虜	ほりょ
補給	ほきゅう
補強	ほきょう
補充	ほじゅう
補助	ほじょ
補償	ほしょう
穂	ほ
募る	つのる
募金	ぼきん
母校	ぼこう
母国	ぼこく
報酬	ほうしゅう
報道	ほうどう
奉仕	ほうし
崩壊	ほうかい
抱っこ	だっこ
放り込む	ほうりこむ
放棄	ほうき
放射能	ほうしゃのう
放出	ほうしゅつ
方策	ほうさく
方式	ほうしき
法案	ほうあん
法学	ほうがく
法廷	ほうてい
砲	ほう
妨害	ぼうがい
暴動	ぼうどう
暴力	ぼうりょく
冒頭	ぼうとう
膨張	ぼうちょう
防衛	ぼうえい
牧師	ぼくし
本音	ほんね
本格	ほんかく
本館	ほんかん
本国	ほんごく
本質	ほんしつ
本場	ほんば
本体	ほんたい
本名	ほんみょう
麻	あさ
埋める	うずめる
埋め込む	うめこむ
膜	まく
末	まつ
満たす	みたす
味わい	あじわい
味覚	みかく
未だ	いまだ
未知	みち
未定	みてい
密接	みっせつ
密度	みつど
民謡	みんよう
無言	むごん
無効	むこう
無線	むせん
無断	むだん
無難	ぶなん
無念	むねん
無用	むよう
名称	めいしょう
名簿	めいぼ
名誉	めいよ
免除	めんじょ
面会	めんかい
模型	もけい
模索	もさく
猛烈	もうれつ
問い合わせる	といあわせる
問う	とう
野外	やがい
野心	やしん
野生	やせい
野党	やとう
矢	や
役場	やくば
役職	やくしょく
優	ゆう
優位	ゆうい
優勢	ゆうせい
優先	ゆうせん
幽霊	ゆうれい
有益	ゆうえき
有機	ゆうき
有望	ゆうぼう
有力	ゆうりょく
誘導	ゆうどう
融資	ゆうし
予め	あらかじめ
予感	よかん
予想	よそう
余地	よち
与党	よとう
預金	よきん
様式	ようしき
様相	ようそう
用紙	ようし
用品	ようひん
要する	ようする
要因	よういん
要請	ようせい
要望	ようぼう
養成	ようせい
抑圧	よくあつ
抑制	よくせい
欲	よく
欲望	よくぼう
落ち込む	おちこむ
濫用	らんよう
利子	りし
利息	りそく
利点	りてん
立体	りったい
立法	りっぽう
流通	りゅうつう
旅客	りょかく
了解	りょうかい
両立	りょうりつ
良好	りょうこう
良識	りょうしき
良質	りょうしつ
領域	りょういき
領土	りょうど
林業	りんぎょう
類	るい
類似	るいじ
暦	こよみ
恋愛	れんあい
連休	れんきゅう
連帯	れんたい
連中	れんちゅう
連日	れんじつ
連邦	れんぽう
連盟	れんめい
露	つゆ
露骨	ろこつ
朗読	ろうどく
論議	ろんぎ
論理	ろんり
惑星	わくせい
枠	わく
駆ける	かける
依存	いぞん
円滑	えんかつ
音色	ねいろ
幹	みき
管	かん
共存	きょうぞん
溝	みぞ
合併	がっぺい
施行	しこう
出生	しゅっしょう
情緒	じょうちょ
誠	まこと
早急	そうきゅう
発足	ほっそく
避ける	よける
描く	かく
文書	ぶんしょ
墓地	ぼち
本文	ほんぶん
万能	ばんのう
問屋	とんや
言い訳	いいわけ
生かす	いかす
育成	いくせい
意向	いこう
意欲	いよく
威力	いりょく
運送	うんそう
箇所	かしょ
傍ら	かたわら
肝心	かんじん
起源	きげん
規範	きはん
綺麗	きれい
区画	くかく
小売	こうり
個々	ここ
収集	しゅうしゅう
侵略	しんりゃく
専用	せんよう
総合	そうごう
添える	そえる
建前	たてまえ
探検	たんけん
貯蓄	ちょちく
手当	てあて
尊い	とうとい
時折	ときおり
届	とどけ
取扱	とりあつかい
取り締まり	とりしまり
取引	とりひき
堂々	どうどう
同盟	どうめい
並	なみ
値引き	ねびき
図る	はかる
華やか	はなやか
引き上げる	ひきあげる
附属	ふぞく
普遍	ふへん
保障	ほしょう
勝る	まさる
麻酔	ますい
末期	まっき
見通し	みとおし
見なす	みなす
民族	みんぞく
民俗	みんぞく
申込	もうしこみ
漏れる	もれる
屋敷	やしき
世	よ
養護	ようご
世論	せろん
理屈	りくつ
略奪	りゃくだつ
了承	りょうしょう
割	わり
汚れ	よごれ
密か	ひそか
衣類	いるい
共和	きょうわ
行ける	いける
碑	いしぶみ
菌	きん
芸	げい
隊	たい
官	かん
強	きょう
苦	く
書	しょ
異	い
条	じょう
寄り	より
当	とう
意	い
界	かい
被	ひ
遍	へん
亜	あ
ずらす	ずらす
どきどき	どきどき
ホスト	ほすと
川	かわ
何れ	いずれ
小母	おば
下	か
起す	おこす
計	けい
図書	としょ
正	せい
茶	ちゃ
田	た
入口	いりぐち
売上	うりあげ
終る	おわる
英和	えいわ
科	か
具体	ぐたい
合理	ごうり
留まる	とどまる
曜日	ようび
何所	どこ
打合せ	うちあわせ
物体ない	もったいない
物	ぶつ
菓子	かし
換気	かんき
間接	かんせつ
共産	きょうさん
御飯	ごはん
状	じょう
全般	ぜんぱん
則ち	すなわち
庁	ちょう
暮れ	くれ
復	また
民主	みんしゅ
友好	ゆうこう
有難い	ありがたい
浴	よく
領収	りょうしゅう
零	れい
押える	おさえる
支払	しはらい
非道い	ひどい
訓	くん
翌	よく
偶	たま
仰る	おっしゃる
討つ	うつ
素	もと
御免	ごめん
擦る	かする
松	まつ
為る	なる
大凡	おおよそ
抽象	ちゅうしょう
堀	ほり
締切	しめきり
徐々に	じょじょに
振舞う	ふるまう
我	わが
滑る	ぬめる
器	き
あの	あの
斬る	きる
須臾	しばらく
手頃	てごろ
芥	ごみ
其の儘	そのまま
殆んど	ほとんど
偖	さて
莨	たばこ
烟草	たばこ
瘠せる	やせる